DATE,TOTAL_CASES,NEW_CASES,TOTAL_CONFIRMED,NEW_CONFIRMED,TOTAL_PROBABLE,NEW_PROBABLE,POS_TESTS,NEG_TESTS,TOTAL_TESTS,NEW_TESTS,NEW_DEATHS,TOTAL_DEATHS,NEW_ACTIVE,TOTAL_ACTIVE,NEW_INACTIVE_RECOVERED,TOTAL_INACTIVE_RECOVERED,NEW_HOSP,TOTAL_HOSP,TOTAL_DEATHS_BY_DOD,NEW_DEATHS_BY_DOD
6/10/2021,865085,244,712440,173,152645,71,821587,7244435,8066022,8654,3,12498,-59,2519,300,850068,3,22126,12492,0
6/9/2021,864841,222,712267,153,152574,69,821359,7236009,8057368,10891,2,12495,-77,2578,297,849768,2,22123,12492,2
6/8/2021,864619,291,712114,190,152505,101,821157,7225320,8046477,7499,2,12493,-71,2655,360,849471,14,22121,12490,5
6/7/2021,864328,273,711924,155,152404,118,820956,7218022,8038978,6040,13,12491,-149,2726,409,849111,14,22107,12485,1
6/6/2021,864055,108,711769,84,152286,24,820756,7212182,8032938,4289,-1,12478,-111,2875,220,848702,3,22093,12484,1
6/5/2021,863947,168,711685,113,152262,55,820665,7207984,8028649,5909,3,12479,-166,2986,331,848482,7,22090,12483,6
6/4/2021,863779,312,711572,213,152207,99,820534,7202206,8022740,9709,1,12476,-81,3152,392,848151,10,22083,12477,2
6/3/2021,863467,328,711359,225,152108,103,820281,7192750,8013031,11962,5,12475,-130,3233,453,847759,13,22073,12475,3
6/2/2021,863139,370,711134,253,152005,117,820002,7181067,8001069,9503,7,12470,-90,3363,453,847306,12,22060,12472,5
6/1/2021,862769,427,710881,279,151888,148,819718,7171848,7991566,6871,9,12463,-59,3453,477,846853,23,22048,12467,3
5/31/2021,862342,189,710602,130,151740,59,819408,7165287,7984695,4081,11,12454,-367,3512,545,846376,6,22025,12464,6
5/30/2021,862153,183,710472,130,151681,53,819251,7161363,7980614,4738,0,12443,-215,3879,398,845831,9,22019,12458,6
5/29/2021,861970,192,710342,135,151628,57,819097,7156779,7975876,5746,2,12443,-230,4094,420,845433,14,22010,12452,3
5/28/2021,861778,326,710207,246,151571,80,818905,7151225,7970130,9628,3,12441,-178,4324,501,845013,4,21996,12449,6
5/27/2021,861452,401,709961,268,151491,133,818612,7141890,7960502,10652,12,12438,-239,4502,628,844512,15,21992,12443,5
5/26/2021,861051,515,709693,375,151358,140,818291,7131559,7949850,12251,22,12426,-94,4741,587,843884,20,21977,12438,8
5/25/2021,860536,433,709318,287,151218,146,817865,7119734,7937599,9271,6,12404,-179,4835,606,843297,14,21957,12430,8
5/24/2021,860103,461,709031,320,151072,141,817556,7110772,7928328,7868,7,12398,-325,5014,779,842691,20,21943,12422,3
5/23/2021,859642,259,708711,192,150931,67,817185,7103275,7920460,5387,6,12391,-229,5339,482,841912,9,21923,12419,7
5/22/2021,859383,313,708519,231,150864,82,816950,7098123,7915073,7490,3,12385,-166,5568,476,841430,14,21914,12412,4
5/21/2021,859070,528,708288,353,150782,175,816646,7090937,7907583,10232,4,12382,-155,5734,679,840954,15,21900,12408,9
5/20/2021,858542,553,707935,393,150607,160,816250,7081101,7897351,24052,16,12378,-222,5889,759,840275,21,21885,12399,10
5/19/2021,857989,639,707542,467,150447,172,815783,7057516,7873299,13946,11,12362,-182,6111,810,839516,27,21864,12389,9
5/18/2021,857350,573,707075,390,150275,183,815238,7044115,7859353,10639,14,12351,-280,6293,839,838706,22,21837,12380,7
5/17/2021,856777,660,706685,393,150092,267,814803,7033911,7848714,9135,12,12337,-314,6573,962,837867,20,21815,12373,10
5/16/2021,856117,276,706292,201,149825,75,814338,7025241,7839579,5291,4,12325,-274,6887,546,836905,16,21795,12363,10
5/15/2021,855841,402,706091,293,149750,109,814087,7020201,7834288,8622,1,12321,-219,7161,620,836359,13,21779,12353,7
5/14/2021,855439,808,705798,590,149641,218,813697,7011969,7825666,12082,10,12320,62,7380,736,835739,31,21766,12346,12
5/13/2021,854631,712,705208,479,149423,233,813027,7000557,7813584,12385,7,12310,-179,7318,884,835003,20,21735,12334,5
5/12/2021,853919,901,704729,651,149190,250,812476,6988723,7801199,17233,9,12303,-37,7497,929,834119,31,21715,12329,10
5/11/2021,853018,847,704078,611,148940,236,811657,6972309,7783966,11470,4,12294,-155,7534,998,833190,31,21684,12319,6
5/10/2021,852171,628,703467,382,148704,246,811018,6961478,7772496,7514,17,12290,-582,7689,1193,832192,30,21653,12313,10
5/9/2021,851543,376,703085,283,148458,93,810583,6954399,7764982,6858,19,12273,-334,8271,691,830999,20,21623,12303,8
5/8/2021,851167,559,702802,398,148365,161,810255,6947869,7758124,10281,0,12254,-84,8605,643,830308,15,21603,12295,10
5/7/2021,850608,1033,702404,739,148204,294,809746,6938097,7747843,14990,2,12254,68,8689,963,829665,26,21588,12285,8
5/6/2021,849575,790,701665,546,147910,244,808899,6923954,7732853,11570,11,12252,-287,8621,1066,828702,24,21562,12277,13
5/5/2021,848785,1208,701119,765,147666,443,808266,6913017,7721283,17611,16,12241,221,8908,971,827636,37,21538,12264,12
5/4/2021,847577,853,700354,601,147223,252,807393,6896279,7703672,12159,11,12225,-308,8687,1150,826665,30,21501,12252,9
5/3/2021,846724,655,699753,450,146971,205,806700,6884813,7691513,8381,13,12214,-639,8995,1281,825515,31,21471,12243,6
5/2/2021,846069,498,699303,374,146766,124,806179,6876953,7683132,7356,1,12201,-226,9634,723,824234,23,21440,12237,11
5/1/2021,845571,609,698929,449,146642,160,805744,6870032,7675776,10355,-1,12200,-131,9860,741,823511,24,21417,12226,7
4/30/2021,844962,1071,698480,772,146482,299,805253,6860168,7665421,14921,7,12201,10,9991,1054,822770,29,21393,12219,10
4/29/2021,843891,1031,697708,686,146183,345,804385,6846115,7650500,14644,9,12194,-117,9981,1139,821716,30,21364,12209,10
4/28/2021,842860,1194,697022,861,145838,333,803606,6832250,7635856,20507,17,12185,-95,10098,1272,820577,45,21334,12199,9
4/27/2021,841666,1159,696161,710,145505,449,802608,6812741,7615349,13778,8,12168,-77,10193,1228,819305,46,21289,12190,12
4/26/2021,840507,1091,695451,713,145056,378,801810,6799761,7601571,9825,11,12160,-378,10270,1458,818077,28,21243,12178,11
4/25/2021,839416,554,694738,426,144678,128,801027,6790719,7591746,8247,6,12149,-269,10648,817,816619,26,21215,12167,7
4/24/2021,838862,752,694312,567,144550,185,800512,6782987,7583499,13041,0,12143,-173,10917,925,815802,31,21189,12160,7
4/23/2021,838110,954,693745,692,144365,262,799869,6770589,7570458,14907,4,12143,-219,11090,1169,814877,25,21158,12153,5
4/22/2021,837156,1851,693053,1049,144103,802,799027,6756524,7555551,22082,12,12139,545,11309,1294,813708,34,21133,12148,12
4/21/2021,835305,1382,692004,943,143301,439,797836,6735633,7533469,17935,19,12127,112,10764,1251,812414,24,21099,12136,15
4/20/2021,833923,1095,691061,901,142862,194,796782,6718752,7515534,13974,15,12108,-269,10652,1349,811163,46,21075,12121,8
4/19/2021,832828,842,690160,550,142668,292,795807,6705753,7501560,9281,15,12093,-697,10921,1524,809814,38,21029,12113,12
4/18/2021,831986,561,689610,480,142376,81,795193,6697086,7492279,8184,17,12078,-161,11618,705,808290,17,20991,12101,11
4/17/2021,831425,704,689130,573,142295,131,794617,6689478,7484095,11805,1,12061,-80,11779,783,807585,17,20974,12090,10
4/16/2021,830721,4216,688557,3997,142164,219,793948,6678342,7472290,35539,14,12060,3238,11859,964,806802,37,20957,12080,6
4/15/2021,826505,1375,684560,1001,141945,374,789254,6647497,7436751,18268,8,12046,157,8621,1210,805838,35,20920,12074,12
4/14/2021,825130,1803,683559,1341,141571,462,788159,6630324,7418483,24922,9,12038,648,8464,1146,804628,36,20885,12062,11
4/13/2021,823327,1132,682218,702,141109,430,786641,6606920,7393561,10965,10,12029,-110,7816,1232,803482,33,20849,12051,11
4/12/2021,822195,1232,681516,882,140679,350,785887,6596709,7382596,9376,7,12019,-157,7926,1382,802250,31,20816,12040,16
4/11/2021,820963,655,680634,461,140329,194,784891,6588329,7373220,7666,3,12012,-186,8083,838,800868,22,20785,12024,5
4/10/2021,820308,873,680173,606,140135,267,784371,6581183,7365554,12240,8,12009,121,8269,744,800030,26,20763,12019,10
4/9/2021,819435,1339,679567,1045,139868,294,783634,6569680,7353314,16474,3,12001,216,8148,1120,799286,37,20737,12009,13
4/8/2021,818096,1149,678522,781,139574,368,782491,6554349,7336840,15049,4,11998,-51,7932,1196,798166,22,20700,11996,5
4/7/2021,816947,1586,677741,1190,139206,396,781606,6540185,7321791,21226,21,11994,330,7983,1235,796970,34,20678,11991,8
4/6/2021,815361,1336,676551,885,138810,451,780305,6520260,7300565,14561,9,11973,69,7653,1258,795735,26,20644,11983,5
4/5/2021,814025,892,675666,518,138359,374,779299,6506705,7286004,6216,38,11964,-621,7584,1475,794477,43,20618,11978,10
4/4/2021,813133,553,675148,417,137985,136,778738,6501050,7279788,9600,7,11926,-262,8205,808,793002,10,20575,11968,16
4/3/2021,812580,896,674731,638,137849,258,778247,6491941,7270188,10428,0,11919,5,8467,891,792194,17,20565,11952,14
4/2/2021,811684,1067,674093,812,137591,255,777525,6482235,7259760,14202,1,11919,-66,8462,1132,791303,18,20548,11938,11
4/1/2021,810617,1252,673281,901,137336,351,776571,6468987,7245558,14412,6,11918,-191,8528,1437,790171,18,20530,11927,7
3/31/2021,809365,1870,672380,1200,136985,670,775578,6455568,7231146,22833,11,11912,593,8719,1266,788734,29,20512,11920,11
3/30/2021,807495,1193,671180,879,136315,314,774194,6434119,7208313,14239,10,11901,-101,8126,1284,787468,35,20483,11909,9
3/29/2021,806302,1193,670301,620,136001,573,773174,6420900,7194074,8854,29,11891,-290,8227,1454,786184,25,20448,11900,6
3/28/2021,805109,815,669681,567,135428,248,772434,6412786,7185220,10825,13,11862,-45,8517,847,784730,24,20423,11894,8
3/27/2021,804294,814,669114,744,135180,70,771785,6402610,7174395,13029,11,11849,3,8562,800,783883,22,20399,11886,9
3/26/2021,803480,996,668370,799,135110,197,770879,6390487,7161366,11720,25,11838,-249,8559,1220,783083,14,20377,11877,15
3/25/2021,802484,1145,667571,869,134913,276,770033,6379613,7149646,16321,20,11813,-112,8808,1237,781863,35,20363,11862,6
3/24/2021,801339,1609,666702,1279,134637,330,769064,6364261,7133325,21261,4,11793,371,8920,1234,780626,28,20328,11856,6
3/23/2021,799730,1171,665423,722,134307,449,767707,6344357,7112064,14454,45,11789,-136,8549,1262,779392,33,20300,11850,12
3/22/2021,798559,1266,664701,808,133858,458,766908,6330702,7097610,9709,34,11744,-65,8685,1297,778130,35,20267,11838,13
3/21/2021,797293,757,663893,564,133400,193,765984,6321917,7087901,8880,5,11710,-8,8750,760,776833,7,20232,11825,13
3/20/2021,796536,754,663329,519,133207,235,765363,6313658,7079021,9692,4,11705,-29,8758,779,776073,17,20225,11812,7
3/19/2021,795782,1942,662810,1288,132972,654,764810,6304519,7069329,22129,28,11701,755,8787,1159,775294,33,20208,11805,11
3/18/2021,793840,1415,661522,970,132318,445,763398,6283802,7047200,18695,23,11673,277,8032,1115,774135,42,20175,11794,14
3/17/2021,792425,1071,660552,825,131873,246,762280,6266225,7028505,15437,8,11650,-83,7755,1146,773020,24,20133,11780,19
3/16/2021,791354,1938,659727,1249,131627,689,761380,6251688,7013068,19029,12,11642,723,7838,1203,771874,50,20109,11761,9
3/15/2021,789416,904,658478,502,130938,402,759937,6234102,6994039,5276,11,11630,-248,7115,1141,770671,24,20059,11752,8
3/14/2021,788512,663,657976,461,130536,202,759391,6229372,6988763,8031,0,11619,-92,7363,755,769530,17,20035,11744,16
3/13/2021,787849,1486,657515,802,130334,684,758836,6221896,6980732,16646,-12,11619,605,7455,893,768775,22,20018,11728,12
3/12/2021,786363,1111,656713,839,129650,272,757902,6206184,6964086,13853,16,11631,-23,6850,1118,767882,13,19996,11716,19
3/11/2021,785252,1366,655874,924,129378,442,756899,6193334,6950233,19245,17,11615,168,6873,1181,766764,15,19983,11697,12
3/10/2021,783886,1602,654950,1137,128936,465,755875,6175113,6930988,23671,18,11598,303,6705,1281,765583,30,19968,11685,25
3/9/2021,782284,1350,653813,806,128471,544,754603,6152714,6907317,17104,32,11580,-37,6402,1355,764302,24,19938,11660,21
3/8/2021,780934,1088,653007,679,127927,409,753654,6136559,6890213,7643,9,11548,-557,6439,1636,762947,15,19914,11639,26
3/7/2021,779846,752,652328,472,127518,280,752881,6129689,6882570,7138,4,11539,-201,6996,949,761311,9,19899,11613,23
3/6/2021,779094,1235,651856,843,127238,392,752305,6123127,6875432,18286,9,11535,169,7197,1057,760362,20,19890,11590,20
3/5/2021,777859,1227,651013,781,126846,446,751277,6105869,6857146,14116,33,11526,-71,7028,1265,759305,14,19870,11570,19
3/4/2021,776632,1608,650232,1066,126400,542,750362,6092668,6843030,25298,42,11493,568,7099,998,758040,27,19856,11551,18
3/3/2021,775024,1309,649166,888,125858,421,749071,6068661,6817732,18074,23,11451,17,6531,1269,757042,22,19829,11533,23
3/2/2021,773715,1551,648278,989,125437,562,748041,6051617,6799658,15998,15,11428,527,6514,1009,755773,32,19807,11510,11
3/1/2021,772164,568,647289,360,124875,208,746869,6036791,6783660,3824,10,11413,-436,5987,994,754764,16,19775,11499,14
2/28/2021,771596,841,646929,583,124667,258,746472,6033364,6779836,10209,18,11403,-70,6423,893,753770,11,19759,11485,13
2/27/2021,770755,1438,646346,856,124409,582,745791,6023836,6769627,18086,16,11385,377,6493,1045,752877,23,19748,11472,16
2/26/2021,769317,1130,645490,793,123827,337,744752,6006789,6751541,11959,56,11369,-561,6116,1635,751832,16,19725,11456,11
2/25/2021,768187,1682,644697,1176,123490,506,743828,5995754,6739582,22425,55,11313,-97,6677,1724,750197,37,19709,11445,23
2/24/2021,766505,1922,643521,1478,122984,444,742473,5974684,6717157,24671,68,11258,-42,6774,1896,748473,39,19672,11422,18
2/23/2021,764583,1846,642043,1133,122540,713,740748,5951738,6692486,16865,45,11190,-375,6816,2176,746577,44,19633,11404,21
2/22/2021,762737,1058,640910,604,121827,454,739507,5936114,6675621,6161,20,11145,-1275,7191,2313,744401,37,19589,11383,23
2/21/2021,761679,871,640306,583,121373,288,738805,5930655,6669460,6860,18,11125,-273,8466,1126,742088,15,19552,11360,30
2/20/2021,760808,1365,639723,837,121085,528,738103,5924497,6662600,12463,51,11107,-57,8739,1371,740962,31,19537,11330,20
2/19/2021,759443,998,638886,644,120557,354,737190,5912947,6650137,6664,7,11056,-926,8796,1917,739591,37,19506,11310,29
2/18/2021,758445,1486,638242,953,120203,533,736457,5907016,6643473,12977,72,11049,-649,9722,2063,737674,43,19469,11281,30
2/17/2021,756959,932,637289,597,119670,335,735380,5895116,6630496,6595,31,10977,-1300,10371,2201,735611,16,19426,11251,38
2/16/2021,756027,1232,636692,788,119335,444,734696,5889205,6623901,9889,17,10946,-1246,11671,2461,733410,30,19410,11213,31
2/15/2021,754795,779,635904,453,118891,326,733808,5880204,6614012,6226,4,10929,-2026,12917,2801,730949,13,19380,11182,26
2/14/2021,754016,1256,635451,900,118565,356,733281,5874505,6607786,13046,31,10925,-357,14943,1582,728148,23,19367,11156,31
2/13/2021,752760,1678,634551,1121,118209,557,732233,5862507,6594740,19165,9,10894,14,15300,1655,726566,30,19344,11125,33
2/12/2021,751082,1928,633430,1382,117652,546,730898,5844677,6575575,22316,81,10885,-395,15286,2242,724911,21,19314,11092,27
2/11/2021,749154,2421,632048,1740,117106,681,729274,5823985,6553259,25273,81,10804,-286,15681,2626,722669,35,19293,11065,34
2/10/2021,746733,2142,630308,1519,116425,623,727283,5800703,6527986,24634,100,10723,-583,15967,2625,720043,39,19258,11031,37
2/9/2021,744591,2700,628789,1783,115802,917,725509,5777843,6503352,21678,65,10623,-591,16550,3226,717418,57,19219,10994,40
2/8/2021,741891,1248,627006,786,114885,462,723372,5758302,6481674,6678,97,10558,-2331,17141,3482,714192,30,19162,10954,36
2/7/2021,740643,1354,626220,941,114423,413,722461,5752535,6474996,12772,6,10461,-438,19472,1786,710710,27,19132,10918,27
2/6/2021,739289,3664,625279,2597,114010,1067,721419,5740805,6462224,39406,58,10455,1596,19910,2010,708924,44,19105,10891,58
2/5/2021,735625,2186,622682,1572,112943,614,718181,5704637,6422818,22738,203,10397,-774,18314,2757,706914,53,19061,10833,49
2/4/2021,733439,2897,621110,2085,112329,812,716221,5683859,6400080,32434,169,10194,-545,19088,3273,704157,69,19008,10784,49
2/3/2021,730542,3349,619025,2259,111517,1090,713868,5653778,6367646,27513,133,10025,20,19633,3196,700884,87,18939,10735,40
2/2/2021,727193,1315,616766,839,110427,476,711299,5628834,6340133,6560,147,9892,-2884,19613,4052,697688,25,18852,10695,43
2/1/2021,725878,1692,615927,1056,109951,636,710396,5623177,6333573,8144,103,9745,-1893,22497,3482,693636,51,18827,10652,51
1/31/2021,724186,2176,614871,1384,109315,792,709246,5616183,6325429,17537,76,9642,-21,24390,2121,690154,48,18776,10601,48
1/30/2021,722010,3523,613487,2946,108523,577,707518,5600374,6307892,38101,113,9566,806,24411,2604,688033,50,18728,10553,50
1/29/2021,718487,1766,610541,1242,107946,524,703993,5565798,6269791,13889,44,9453,-1902,23605,3624,685429,36,18678,10503,55
1/28/2021,716721,3963,609299,2022,107422,1941,702497,5553405,6255902,20461,101,9409,-358,25507,4220,681805,82,18642,10448,70
1/27/2021,712758,2727,607277,2068,105481,659,700230,5535211,6235441,20351,154,9308,-1241,25865,3814,677585,59,18560,10378,62
1/26/2021,710031,3140,605209,2324,104822,816,697942,5517148,6215090,22535,192,9154,-1935,27106,4883,673771,72,18501,10316,82
1/25/2021,706891,1823,602885,1222,104006,601,695353,5497202,6192555,11639,111,8962,-3532,29041,5244,668888,52,18429,10234,76
1/24/2021,705068,1599,601663,1309,103405,290,693977,5486939,6180916,13245,40,8851,-1667,32573,3226,663644,40,18377,10158,83
1/23/2021,703469,4490,600354,3174,103115,1316,692454,5475217,6167671,38165,42,8811,1095,34240,3353,660418,88,18337,10075,73
1/22/2021,698979,2637,597180,1968,101799,669,688406,5441100,6129506,21622,93,8769,-2529,33145,5073,657065,52,18249,10002,74
1/21/2021,696342,4712,595212,3511,101130,1201,686126,5421758,6107884,31104,128,8676,-1957,35674,6541,651992,83,18197,9928,107
1/20/2021,691630,3115,591701,2100,99929,1015,682180,5394600,6076780,19972,86,8548,-2783,37631,5812,645451,57,18114,9821,86
1/19/2021,688515,4773,589601,2783,98914,1990,679733,5377075,6056808,22858,40,8462,-3171,40414,7904,639639,112,18057,9735,99
1/18/2021,683742,1617,586818,1068,96924,549,676409,5357541,6033950,7863,39,8422,-7221,43585,8799,631735,42,17945,9636,80
1/17/2021,682125,2569,585750,1876,96375,693,675318,5350769,6026087,15253,36,8383,-1897,50806,4430,622936,52,17903,9556,90
1/16/2021,679556,6931,583874,5346,95682,1585,673253,5337581,6010834,46111,44,8347,1313,52703,5574,618506,125,17851,9466,89
1/15/2021,672625,2759,578528,1817,94097,942,666739,5297984,5964723,14576,79,8303,-674,51390,3354,612932,59,17726,9377,90
1/14/2021,669866,6160,576711,4804,93155,1356,664764,5285383,5950147,37421,84,8224,-280,52064,6356,609578,99,17667,9287,106
1/13/2021,663706,4119,571907,2876,91799,1243,659210,5253516,5912726,20733,137,8140,-4031,52344,8013,603222,65,17568,9181,77
1/12/2021,659587,4748,569031,3015,90556,1733,656204,5235789,5891993,20597,146,8003,-6004,56375,10606,595209,75,17503,9104,98
1/11/2021,654839,3787,566016,2680,88823,1107,652952,5218444,5871396,14867,80,7857,-6343,62379,10050,584603,77,17428,9006,102
1/10/2021,651052,5380,563336,3698,87716,1682,650022,5206507,5856529,29943,81,7777,1027,68722,4272,574553,84,17351,8904,108
1/9/2021,645672,7222,559638,5752,86034,1470,645407,5181179,5826586,39408,86,7696,2005,67695,5131,570281,89,17267,8796,89
1/8/2021,638450,6056,553886,4580,84564,1476,638703,5148475,5787178,33865,126,7610,4245,65690,1685,565150,96,17178,8707,118
1/7/2021,632394,7342,549306,6305,83088,1037,632729,5120584,5753313,33686,111,7484,3149,61445,4082,563465,99,17082,8589,91
1/6/2021,625052,7361,543001,5165,82051,2196,626363,5093264,5719627,28868,114,7373,437,58296,6810,559383,129,16983,8498,115
1/5/2021,617691,8407,537836,5150,79855,3257,620837,5069922,5690759,25819,99,7259,-776,57859,9084,552573,129,16854,8383,115
1/4/2021,609284,4051,532686,3004,76598,1047,615517,5049423,5664940,10890,143,7160,-4626,58635,8534,543489,67,16725,8268,107
1/3/2021,605233,3515,529682,2375,75551,1140,612544,5041506,5654050,12404,55,7017,-258,63261,3718,534955,56,16658,8161,103
1/2/2021,601718,7198,527307,5732,74411,1466,610102,5031544,5641646,30031,15,6962,3108,63519,4075,531237,98,16602,8058,86
1/1/2021,594520,6680,521575,5227,72945,1453,603543,5008072,5611615,28065,48,6947,-400,60411,7032,527162,77,16504,7972,97
12/31/2020,587840,9175,516348,7241,71492,1934,597938,4985612,5583550,35511,97,6899,1924,60811,7154,520130,74,16427,7875,99
12/30/2020,578665,6701,509107,4536,69558,2165,589853,4958186,5548039,22248,100,6802,-713,58887,7314,512976,81,16353,7776,99
12/29/2020,571964,8078,504571,4958,67393,3120,584912,4940879,5525791,23328,122,6702,65,59600,7891,505662,115,16272,7677,98
12/28/2020,563886,3548,499613,2633,64273,915,579592,4922871,5502463,10180,76,6580,-6591,59535,10063,497771,79,16157,7579,89
12/27/2020,560338,3379,496980,2296,63358,1083,576743,4915540,5492283,13186,69,6504,-446,66126,3756,487708,76,16078,7490,87
12/26/2020,556959,4890,494684,3550,62275,1340,573966,4905131,5479097,21741,7,6435,848,66572,4035,483952,86,16002,7403,91
12/25/2020,552069,6630,491134,5440,60935,1190,570086,4887270,5457356,33411,5,6428,-564,65724,7189,479917,55,15916,7312,80
12/24/2020,545439,6645,485694,5029,59745,1616,564057,4859888,5423945,32439,51,6423,-520,66288,7114,472728,46,15861,7232,107
12/23/2020,538794,6095,480665,3974,58129,2121,558333,4833173,5391506,26392,111,6372,-1330,66808,7314,465614,84,15815,7125,97
12/22/2020,532699,6908,476691,4714,56008,2194,553759,4811355,5365114,29080,133,6261,-815,68138,7590,458300,125,15731,7028,109
12/21/2020,525791,5823,471977,4379,53814,1444,548484,4787550,5336034,26611,65,6128,-3914,68953,9672,450710,83,15606,6919,104
12/20/2020,519968,9995,467598,8347,52370,1648,543596,4765827,5309423,61062,54,6063,6433,72867,3508,441038,107,15523,6815,101
12/19/2020,509973,7073,459251,6035,50722,1038,534030,4714331,5248361,41319,57,6009,3188,66434,3828,437530,70,15416,6714,93
12/18/2020,502900,8264,453216,6983,49684,1281,526628,4680414,5207042,40585,115,5952,1881,63246,6268,433702,93,15346,6621,96
12/17/2020,494636,10155,446233,8059,48403,2096,519186,4647271,5166457,44532,177,5837,3149,61365,6829,427434,116,15253,6525,92
12/16/2020,484481,9314,438174,6480,46307,2834,510524,4611401,5121925,35796,53,5660,2271,58216,6990,420605,145,15137,6433,85
12/15/2020,475167,11807,431694,10299,43473,1508,503411,4582718,5086129,65200,74,5607,4591,55945,7142,413615,158,14992,6348,66
12/14/2020,463360,7918,421395,6855,41965,1063,491712,4529217,5020929,42297,79,5533,-2544,51354,10383,406473,111,14834,6282,76
12/13/2020,455442,11210,414540,9831,40902,1379,483943,4494689,4978632,68964,62,5454,7737,53898,3411,396090,122,14723,6206,85
12/12/2020,444232,8917,404709,7298,39523,1619,472874,4436794,4909668,47598,73,5392,5029,46161,3815,392679,135,14601,6121,79
12/11/2020,435315,6024,397411,5094,37904,930,464582,4397488,4862070,32150,87,5319,1709,41132,4228,388864,115,14466,6042,68
12/10/2020,429291,8869,392317,7753,36974,1116,458972,4370948,4829920,52295,69,5232,7542,39423,1258,384636,123,14351,5974,75
12/9/2020,420422,5791,384564,5107,35858,684,450176,4327449,4777625,27593,62,5163,148,31881,5581,383378,99,14228,5899,62
12/8/2020,414631,8071,379457,6997,35174,1074,444549,4305483,4750032,45056,100,5101,2353,31733,5618,377797,107,14129,5837,79
12/7/2020,406560,7126,372460,6124,34100,1002,436841,4268135,4704976,35767,66,5001,-711,29380,7771,372179,87,14022,5758,72
12/6/2020,399434,4042,366336,3404,33098,638,430173,4239036,4669209,19687,38,4935,1159,30091,2845,364408,45,13935,5686,86
12/5/2020,395392,3056,362932,2510,32460,546,426434,4223088,4649522,15624,29,4897,16,28932,3011,361563,51,13890,5600,78
12/4/2020,392336,5356,360422,4283,31914,1073,423756,4210142,4633898,26992,95,4868,-315,28916,5576,358552,94,13839,5522,83
12/3/2020,386980,4790,356139,3985,30841,805,418913,4187993,4606906,25632,93,4773,579,29231,4118,352976,82,13745,5439,72
12/2/2020,382190,2498,352154,2106,30036,392,414440,4166834,4581274,11851,50,4680,-2537,28652,4985,348858,58,13663,5367,67
12/1/2020,379692,6663,350048,5668,29644,995,412286,4157137,4569423,36168,36,4630,1048,31189,5579,343873,111,13605,5300,68
11/30/2020,373029,5958,344380,5386,28649,572,406147,4127108,4533255,40744,48,4594,-1185,30141,7095,338294,89,13494,5232,80
11/29/2020,367071,5499,338994,5072,28077,427,400160,4092351,4492511,37922,13,4546,2485,31326,3001,331199,70,13405,5152,57
11/28/2020,361572,4684,333922,4063,27650,621,394444,4060145,4454589,31917,15,4533,1604,28841,3065,328198,73,13335,5095,61
11/27/2020,356888,5382,329859,4798,27029,584,389863,4032809,4422672,32627,7,4518,387,27237,4988,325133,81,13262,5034,80
11/26/2020,351506,5263,325061,4908,26445,355,384314,4005731,4390045,52384,53,4511,-440,26850,5650,320145,60,13181,4954,47
11/25/2020,346243,2171,320153,1573,26090,598,378430,3959231,4337661,12056,92,4458,-2378,27290,4457,314495,90,13121,4907,64
11/24/2020,344072,2043,318580,1514,25492,529,376989,3948616,4325605,10731,73,4366,-3432,29668,5402,310038,90,13031,4843,66
11/23/2020,342029,2200,317066,1843,24963,357,375485,3939389,4314874,11111,35,4293,-4653,33100,6818,304636,70,12941,4777,68
11/22/2020,339829,5531,315223,5036,24606,495,373618,3930145,4303763,43848,55,4258,2885,37753,2591,297818,110,12871,4709,59
11/21/2020,334298,3408,310187,2891,24111,517,367928,3891987,4259915,25928,9,4203,795,34868,2604,295227,81,12761,4650,74
11/20/2020,330890,4019,307296,3509,23594,510,364769,3869218,4233987,24329,74,4194,-48,34073,3993,292623,66,12680,4576,67
11/19/2020,326871,2989,303787,2281,23084,708,360945,3848713,4209658,16860,80,4120,-1343,34121,4252,288630,82,12614,4509,57
11/18/2020,323882,4015,301506,3037,22376,978,358513,3834285,4192798,24015,53,4040,-99,35464,4061,284378,95,12532,4452,43
11/17/2020,319867,3497,298469,3177,21398,320,355061,3813722,4168783,21235,72,3987,-120,35563,3545,280317,66,12437,4409,68
11/16/2020,316370,4634,295292,4225,21078,409,351503,3796045,4147548,35156,30,3915,-71,35683,4675,276772,77,12371,4341,51
11/15/2020,311736,6440,291067,5833,20669,607,346849,3765543,4112392,55514,16,3885,4500,35754,1924,272097,110,12294,4290,48
11/14/2020,305296,4873,285234,4444,20062,429,340237,3716641,4056878,38278,25,3869,3055,31254,1793,270173,85,12184,4242,60
11/13/2020,300423,4357,280790,3743,19633,614,335214,3683386,4018600,27156,64,3844,1532,28199,2761,268380,69,12099,4182,43
11/12/2020,296066,3127,277047,2561,19019,566,331221,3660223,3991444,19289,27,3780,400,26667,2700,265619,54,12030,4139,36
11/11/2020,292939,3908,274486,3290,18453,618,328483,3643672,3972155,28166,89,3753,982,26267,2837,262919,70,11976,4103,50
11/10/2020,289031,3017,271196,2483,17835,534,324651,3619338,3943989,25716,62,3664,84,25285,2871,260082,83,11906,4053,49
11/9/2020,286014,2374,268713,2045,17301,329,321890,3596383,3918273,19710,15,3602,-884,25201,3243,257211,43,11823,4004,42
11/8/2020,283640,5378,266668,4842,16972,536,319590,3578973,3898563,54998,5,3587,3559,26085,1814,253968,87,11780,3962,40
11/7/2020,278262,4168,261826,3841,16436,327,314058,3529507,3843565,43211,49,3582,2248,22526,1871,252154,87,11693,3922,33
11/6/2020,274094,3591,257985,3021,16109,570,309546,3490808,3800354,28579,32,3533,949,20278,2610,250283,62,11606,3889,47
11/5/2020,270503,1398,254964,1106,15539,292,306177,3465598,3771775,10918,31,3501,-1322,19329,2689,247673,51,11544,3842,40
11/4/2020,269105,2640,253858,2343,15247,297,304962,3455895,3760857,23445,24,3470,-173,20651,2789,244984,67,11493,3802,50
11/3/2020,266465,3010,251515,2708,14950,302,302348,3435064,3737412,24942,75,3446,231,20824,2704,242195,53,11426,3752,45
11/2/2020,263455,1895,248807,1771,14648,124,299295,3413175,3712470,16683,26,3371,-1347,20593,3216,239491,63,11373,3707,38
11/1/2020,261560,2476,247036,2112,14524,364,297346,3398441,3695787,34030,0,3345,773,21940,1703,236275,64,11310,3669,32
10/31/2020,259084,149,244924,137,14160,12,294850,3366907,3661757,807,12,3345,-1540,21167,1677,234572,2,11246,3637,29
10/30/2020,258935,2394,244787,2177,14148,217,294711,3366239,3660950,22319,78,3333,83,22707,2233,232895,62,11244,3608,40
10/29/2020,256541,2365,242610,2031,13931,334,292378,3346253,3638631,25461,22,3255,24,22624,2319,230662,66,11182,3568,37
10/28/2020,254176,2673,240579,2389,13597,284,290083,3323087,3613170,23102,34,3233,138,22600,2501,228343,67,11116,3531,38
10/27/2020,251503,2445,238190,2040,13313,405,287450,3302618,3590068,22839,44,3199,-12,22462,2413,225842,101,11049,3493,46
10/26/2020,249058,1505,236150,1317,12908,188,285160,3282069,3567229,11257,32,3155,-1378,22474,2851,223429,45,10948,3447,31
10/25/2020,247553,3083,234833,2895,12720,188,283712,3272260,3555972,35744,31,3123,1583,23852,1469,220578,82,10903,3416,42
10/24/2020,244470,3606,231938,3311,12532,295,280235,3239993,3520228,39865,24,3092,1915,22269,1667,219109,85,10821,3374,45
10/23/2020,240864,2654,228627,2403,12237,251,276417,3203946,3480363,29987,65,3068,500,20354,2089,217442,73,10736,3329,33
10/22/2020,238210,3182,226224,2831,11986,351,273747,3176629,3450376,35902,41,3003,1132,19854,2009,215353,90,10663,3296,28
10/21/2020,235028,1731,223393,1486,11635,245,270541,3143933,3414474,15342,18,2962,-535,18722,2248,213344,44,10573,3268,38
10/20/2020,233297,1966,221907,1681,11390,285,268827,3130305,3399132,18695,30,2944,-80,19257,2016,211096,60,10529,3230,37
10/19/2020,231331,2185,220226,1991,11105,194,266802,3113635,3380437,20251,13,2914,-177,19337,2349,209080,91,10469,3193,33
10/18/2020,229146,2635,218235,2462,10911,173,264762,3095424,3360186,39714,6,2901,1323,19514,1306,206731,73,10378,3160,21
10/17/2020,226511,2683,215773,2478,10738,205,261853,3058619,3320472,36778,32,2895,1303,18191,1348,205425,75,10305,3139,27
10/16/2020,223828,1719,213295,1526,10533,193,258864,3024830,3283694,16342,7,2863,-141,16888,1853,204077,44,10230,3112,29
10/15/2020,222109,1422,211769,1221,10340,201,257293,3010059,3267352,16243,36,2856,-325,17029,1711,202224,52,10186,3083,41
10/14/2020,220687,2311,210548,2109,10139,202,255949,2995160,3251109,22127,31,2820,561,17354,1719,200513,67,10134,3042,37
10/13/2020,218376,1544,208439,1268,9937,276,253740,2975242,3228982,16119,23,2789,-18,16793,1539,198794,54,10067,3005,36
10/12/2020,216832,1231,207171,1049,9661,182,252298,2960565,3212863,15370,7,2766,-827,16811,2051,197255,43,10013,2969,36
10/11/2020,215601,2950,206122,2749,9479,201,251093,2946400,3197493,42912,9,2759,1855,17638,1086,195204,92,9970,2933,28
10/10/2020,212651,1886,203373,1778,9278,108,247940,2906641,3154581,29444,26,2750,835,15783,1025,194118,51,9878,2905,29
10/9/2020,210765,1417,201595,1246,9170,171,245914,2879223,3125137,26236,27,2724,52,14948,1338,193093,41,9827,2876,26
10/8/2020,209348,2002,200349,1812,8999,190,244505,2854396,3098901,25611,63,2697,539,14896,1400,191755,67,9786,2850,26
10/7/2020,207346,1841,198537,1575,8809,266,242568,2830722,3073290,23387,21,2634,350,14357,1470,190355,74,9719,2824,28
10/6/2020,205505,1997,196962,1699,8543,298,240825,2809078,3049903,25398,24,2613,445,14007,1528,188885,91,9645,2796,27
10/5/2020,203508,2216,195263,2003,8245,213,238861,2785644,3024505,35559,20,2589,368,13562,1828,187357,90,9554,2769,25
10/4/2020,201292,1817,193260,1663,8032,154,236367,2752579,2988946,38317,17,2569,883,13194,917,185529,67,9464,2744,29
10/3/2020,199475,1356,191597,1244,7878,112,234179,2716450,2950629,29108,45,2552,341,12311,970,184612,44,9397,2715,18
10/2/2020,198119,1205,190353,1064,7766,141,232584,2688937,2921521,15620,14,2507,-294,11970,1485,183642,43,9353,2697,22
10/1/2020,196914,1147,189289,1006,7625,141,231299,2674602,2905901,18503,47,2493,-312,12264,1412,182157,51,9310,2675,21
9/30/2020,195767,1427,188283,1251,7484,176,230110,2657288,2887398,13516,34,2446,-87,12576,1480,180745,36,9259,2654,26
9/29/2020,194340,1190,187032,974,7308,216,228643,2645239,2873882,20736,31,2412,-293,12663,1452,179265,63,9223,2628,14
9/28/2020,193150,678,186058,547,7092,131,227345,2625801,2853146,8424,12,2381,-1228,12956,1894,177813,32,9160,2614,26
9/27/2020,192472,1366,185511,1276,6961,90,226633,2618089,2844722,29506,3,2369,435,14184,928,175919,54,9128,2588,24
9/26/2020,191106,2120,184235,1978,6871,142,225087,2590129,2815216,44196,22,2366,1031,13749,1067,174991,60,9074,2564,23
9/25/2020,188986,1344,182257,1245,6729,99,222605,2548415,2771020,26152,42,2344,-116,12718,1418,173924,48,9014,2541,23
9/24/2020,187642,1400,181012,1231,6630,169,221087,2523781,2744868,27190,35,2302,-101,12834,1466,172506,51,8966,2518,20
9/23/2020,186242,916,179781,799,6461,117,219575,2498103,2717678,9432,14,2267,-626,12935,1528,171040,25,8915,2498,28
9/22/2020,185326,1644,178982,1421,6344,223,218642,2489604,2708246,25545,28,2253,-181,13561,1797,169512,56,8890,2470,20
9/21/2020,183682,668,177561,522,6121,146,216743,2465958,2682701,7092,15,2225,-394,13742,1047,167715,40,8834,2450,20
9/20/2020,183014,1027,177039,913,5975,114,216034,2459575,2675609,20439,2,2210,140,14136,885,166668,38,8794,2430,26
9/19/2020,181987,2134,176126,2034,5861,100,214831,2440339,2655170,48376,20,2208,1210,13996,904,165783,82,8756,2404,18
9/18/2020,179853,1503,174092,1333,5761,170,212321,2394473,2606794,30068,32,2188,-309,12786,1780,164879,49,8674,2386,28
9/17/2020,178350,1825,172759,1686,5591,139,210626,2366100,2576726,27796,13,2156,424,13095,1388,163099,54,8625,2358,26
9/16/2020,176525,1062,171073,926,5452,136,208583,2340347,2548930,16763,24,2143,-372,12671,1410,161711,41,8571,2332,21
9/15/2020,175463,1908,170147,1685,5316,223,207390,2324777,2532167,34212,30,2119,309,13043,1569,160301,68,8530,2311,17
9/14/2020,173555,1599,168462,1434,5093,165,205107,2292848,2497955,22957,19,2089,-71,12734,1651,158732,78,8462,2294,27
9/13/2020,171956,1397,167028,1312,4928,85,203321,2271677,2474998,22917,14,2070,389,12805,994,157081,44,8384,2267,14
9/12/2020,170559,1330,165716,1253,4843,77,201630,2250451,2452081,26723,39,2056,464,12416,827,156087,42,8340,2253,35
9/11/2020,169229,1008,164463,895,4766,113,199979,2225379,2425358,14960,37,2017,-1369,11952,2340,155260,40,8298,2218,28
9/10/2020,168221,2001,163568,1823,4653,178,198863,2211535,2410398,31630,57,1980,518,13321,1426,152920,76,8258,2190,23
9/9/2020,166220,1147,161745,1042,4475,105,196625,2182143,2378768,17732,35,1923,-342,12803,1454,151494,56,8182,2167,23
9/8/2020,165073,816,160703,707,4370,109,195280,2165756,2361036,13084,27,1888,-751,13145,1540,150040,47,8126,2144,25
9/7/2020,164257,782,159996,735,4261,47,194425,2153527,2347952,8063,4,1861,-961,13896,1739,148500,33,8079,2119,17
9/6/2020,163475,827,159261,774,4214,53,193288,2146601,2339889,12304,3,1857,-63,14857,887,146761,38,8046,2102,35
9/5/2020,162648,2555,158487,2486,4161,69,192376,2135209,2327585,35053,25,1854,1524,14920,1006,145874,48,8008,2067,21
9/4/2020,160093,1115,156001,1036,4092,79,189453,2103079,2292532,13450,22,1829,-158,13396,1251,144868,46,7960,2046,21
9/3/2020,158978,1655,154965,1513,4013,142,188266,2090816,2279082,28416,18,1807,20,13554,1617,143617,56,7914,2025,22
9/2/2020,157323,1187,153452,1079,3871,108,186371,2064295,2250666,16457,16,1789,-327,13534,1498,142000,53,7858,2003,23
9/1/2020,156136,1691,152373,1527,3763,164,185131,2049078,2234209,22885,27,1773,112,13861,1552,140502,66,7805,1980,22
8/31/2020,154445,1244,150846,1174,3599,70,183151,2028173,2211324,12928,7,1746,-352,13749,1589,138950,39,7739,1958,24
8/30/2020,153201,1461,149672,1428,3529,33,181737,2016659,2198396,8728,22,1739,524,14101,915,137361,34,7700,1934,15
8/29/2020,151740,1533,148244,1425,3496,108,180132,2009536,2189668,25347,24,1717,367,13577,1142,136446,50,7666,1919,25
8/28/2020,150207,1128,146819,1074,3388,54,178346,1985975,2164321,12666,28,1693,-475,13210,1575,135304,44,7616,1894,23
8/27/2020,149079,2329,145745,2206,3334,123,177076,1974579,2151655,37146,25,1665,900,13685,1404,133729,68,7572,1871,25
8/26/2020,146750,1321,143539,1205,3211,116,174358,1940151,2114509,18259,20,1640,-393,12785,1694,132325,55,7504,1846,30
8/25/2020,145429,1708,142334,1590,3095,118,172818,1923432,2096250,30303,40,1620,110,13178,1558,130631,67,7449,1816,24
8/24/2020,143721,644,140744,532,2977,112,170818,1895129,2065947,7169,21,1580,-1402,13068,2025,129073,41,7382,1792,35
8/23/2020,143077,813,140212,750,2865,63,170111,1888667,2058778,14422,4,1559,-208,14470,1017,127048,42,7341,1757,24
8/22/2020,142264,2432,139462,2369,2802,63,169196,1875160,2044356,51997,14,1555,1237,14678,1181,126031,70,7299,1733,17
8/21/2020,139832,528,137093,485,2739,43,166265,1826094,1992359,10316,61,1541,-1227,13441,1694,124850,31,7229,1716,20
8/20/2020,139304,2444,136608,2270,2696,174,165704,1816339,1982043,42955,36,1480,751,14668,1657,123156,84,7198,1696,20
8/19/2020,136860,1344,134338,1278,2522,66,162898,1776190,1939088,20196,26,1444,-539,13917,1857,121499,55,7114,1676,22
8/18/2020,135516,1779,133060,1660,2456,119,161338,1757554,1918892,37964,39,1418,-209,14456,1949,119642,65,7059,1654,16
8/17/2020,133737,850,131400,714,2337,136,158860,1722068,1880928,9309,21,1379,-1307,14665,2136,117693,57,6994,1638,19
8/16/2020,132887,1405,130686,1378,2201,27,157983,1713636,1871619,20001,21,1358,299,15972,1085,115557,41,6937,1619,30
8/15/2020,131482,1936,129308,1851,2174,85,156182,1695436,1851618,27219,19,1337,593,15673,1324,114472,61,6896,1589,29
8/14/2020,129546,1378,127457,1296,2089,82,153665,1670734,1824399,15144,13,1318,-352,15080,1717,113148,47,6835,1560,22
8/13/2020,128168,2528,126161,2429,2007,99,152025,1657230,1809255,36797,24,1305,586,15432,1918,111431,123,6788,1538,23
8/12/2020,125640,1257,123732,1216,1908,41,148673,1623785,1772458,13614,18,1281,-762,14846,2001,109513,60,6665,1515,25
8/11/2020,124383,1811,122516,1697,1867,114,147293,1611551,1758844,24272,38,1263,-165,15608,1938,107512,78,6605,1490,26
8/10/2020,122572,904,120819,852,1753,52,145117,1589455,1734572,8461,10,1225,-1483,15773,2377,105574,71,6527,1464,29
8/9/2020,121668,1575,119967,1547,1701,28,144138,1581973,1726111,17484,8,1215,459,17256,1108,103197,50,6456,1435,14
8/8/2020,120093,2112,118420,2049,1673,63,142235,1566392,1708627,33927,9,1207,943,16797,1160,102089,56,6406,1421,21
8/7/2020,117981,1797,116371,1745,1610,52,139602,1535098,1674700,18541,20,1198,105,15854,1672,100929,103,6350,1400,25
8/6/2020,116184,2743,114626,2631,1558,112,137444,1518715,1656159,32144,42,1178,991,15749,1710,99257,108,6247,1375,25
8/5/2020,113441,1345,111995,1277,1446,68,134159,1489856,1624015,14149,27,1136,-665,14758,1983,97547,55,6139,1350,17
8/4/2020,112096,1760,110718,1676,1378,84,132629,1477237,1609866,21036,25,1109,-385,15423,2120,95564,97,6084,1333,20
8/3/2020,110336,1806,109042,1773,1294,33,130525,1458305,1588830,16891,19,1084,-707,15808,2494,93444,63,5987,1313,25
8/2/2020,108530,1080,107269,1056,1261,24,128442,1443497,1571939,13152,6,1065,-75,16515,1149,90950,53,5924,1288,37
8/1/2020,107450,2179,106213,2150,1237,29,127159,1431628,1558787,31933,7,1059,827,16590,1345,89801,68,5871,1251,23
7/31/2020,105271,1754,104063,1705,1208,49,124373,1402481,1526854,18345,27,1052,-114,15763,1841,88456,72,5803,1228,27
7/30/2020,103517,3592,102358,3549,1159,43,122423,1386086,1508509,43225,13,1025,1653,15877,1926,86615,139,5731,1201,29
7/29/2020,99925,1185,98809,1156,1116,29,118045,1347239,1465284,9360,21,1012,-1249,14224,2413,84689,70,5592,1172,32
7/28/2020,98740,2514,97653,2470,1087,44,116784,1339140,1455924,28734,21,991,131,15473,2362,82276,139,5522,1140,21
7/27/2020,96226,1925,95183,1887,1043,38,113693,1313497,1427190,18048,11,970,-806,15342,2720,79914,107,5383,1119,17
7/26/2020,94301,2329,93296,2276,1005,53,111432,1297710,1409142,26806,3,959,994,16148,1332,77194,81,5276,1102,21
7/25/2020,91972,3102,91020,3062,952,40,108585,1273751,1382336,42414,26,956,1614,15154,1462,75862,117,5195,1081,20
7/24/2020,88870,1864,87958,1819,912,45,104378,1235544,1339922,19344,13,930,-351,13540,2202,74400,99,5078,1061,28
7/23/2020,87006,2546,86139,2497,867,49,102386,1218192,1320578,37683,37,917,397,13891,2112,72198,126,4979,1033,27
7/22/2020,84460,2002,83642,1973,818,29,99165,1183730,1282895,17103,17,880,-464,13494,2449,70086,94,4853,1006,30
7/21/2020,82458,3167,81669,3140,789,27,96866,1168926,1265792,39885,24,863,602,13958,2541,67637,155,4759,976,17
7/20/2020,79291,1204,78529,1167,762,37,92951,1132956,1225907,9667,4,839,-1613,13356,2813,65096,54,4604,959,20
7/19/2020,78087,1582,77362,1559,725,23,91635,1124605,1216240,18789,5,835,-20,14969,1597,62283,63,4550,939,16
7/18/2020,76505,2133,75803,2111,702,22,89686,1107765,1197451,26477,23,830,825,14989,1285,60686,82,4487,923,17
7/17/2020,74372,2132,73692,2087,680,45,86991,1083983,1170974,22069,19,807,515,14164,1598,59401,90,4405,906,16
7/16/2020,72240,2976,71605,2934,635,42,84435,1064470,1148905,39878,13,788,1110,13649,1853,57803,118,4315,890,19
7/15/2020,69264,1934,68671,1897,593,37,80559,1028468,1109027,19687,16,775,-122,12539,2040,55950,96,4197,871,17
7/14/2020,67330,2123,66774,2081,556,42,78358,1010982,1089340,23621,18,759,216,12661,1889,53910,101,4101,854,11
7/13/2020,65207,1831,64693,1800,514,31,75866,989853,1065719,17315,8,741,-92,12445,1915,52021,75,4000,843,19
7/12/2020,63376,2325,62893,2300,483,25,73866,974538,1048404,28256,3,733,1219,12537,1103,50106,101,3925,824,17
7/11/2020,61051,1179,60593,1165,458,14,71001,949147,1020148,15437,15,730,12,11318,1152,49003,51,3824,807,13
7/10/2020,59872,1981,59428,1953,444,28,69449,935262,1004711,18333,13,715,563,11306,1405,47851,93,3773,794,17
7/9/2020,57891,1807,57475,1781,416,26,67231,919147,986378,25175,25,702,377,10743,1405,46446,90,3680,777,17
7/8/2020,56084,1654,55694,1629,390,25,65161,896042,961203,19196,20,677,57,10366,1577,45041,81,3590,760,12
7/7/2020,54430,2154,54065,2144,365,10,63275,878732,942007,27244,12,657,720,10309,1422,43464,113,3509,748,18
7/6/2020,52276,892,51921,878,355,14,60603,854160,914763,8255,7,645,-617,9589,1502,42042,61,3396,730,11
7/5/2020,51384,1346,51043,1344,341,2,59683,846825,906508,15252,9,638,573,10206,764,40540,42,3335,719,18
7/4/2020,50038,1461,49699,1459,339,2,58105,833151,891256,21498,4,629,623,9633,834,39776,57,3293,701,17
7/3/2020,48577,1350,48240,1342,337,8,56242,813516,869758,16408,13,625,311,9010,1026,38942,55,3236,684,12
7/2/2020,47227,1922,46898,1914,329,8,54748,798602,853350,26102,11,612,987,8699,924,37916,82,3181,672,9
7/1/2020,45305,1429,44984,1424,321,5,52432,774816,827248,18372,5,601,465,7712,959,36992,62,3099,663,13
6/30/2020,43876,1654,43560,1642,316,12,50725,758151,808876,25385,12,596,775,7247,867,36033,64,3037,650,12
6/29/2020,42222,1787,41918,1780,304,7,48537,734954,783491,23017,0,584,797,6472,990,35166,89,2973,638,8
6/28/2020,40435,655,40138,653,297,2,46520,713954,760474,10257,0,584,221,5675,434,34176,16,2884,630,8
6/27/2020,39780,264,39485,258,295,6,45700,704517,750217,1850,7,584,-335,5454,592,33742,20,2868,622,8
6/26/2020,39516,979,39227,955,289,24,45461,702906,748367,10322,10,577,292,5789,677,33150,59,2848,614,14
6/25/2020,38537,1083,38272,1073,265,10,44442,693603,738045,14114,11,567,440,5497,632,32473,49,2789,600,9
6/24/2020,37454,842,37199,834,255,8,43209,680722,723931,8465,14,556,119,5057,709,31841,48,2740,591,7
6/23/2020,36612,1017,36365,1010,247,7,42227,673239,715466,11214,11,542,363,4938,643,31132,59,2692,584,5
6/22/2020,35595,626,35355,614,240,12,41086,663166,704252,10540,5,531,-188,4575,809,30489,25,2633,579,6
6/21/2020,34969,596,34741,595,228,1,40469,653243,693712,13743,2,526,201,4763,393,29680,21,2608,573,10
6/20/2020,34373,409,34146,408,227,1,39628,640341,679969,9212,0,524,-63,4562,472,29287,24,2587,563,6
6/19/2020,33964,745,33738,741,226,4,39079,631678,670757,10181,15,524,218,4625,512,28815,41,2563,557,9
6/18/2020,33219,1098,32997,1096,222,2,38192,622384,660576,15630,12,509,498,4407,588,28303,71,2522,548,5
6/17/2020,32121,408,31901,404,220,4,36939,608007,644946,5422,4,497,-218,3909,622,27715,22,2451,543,10
6/16/2020,31713,614,31497,611,216,3,36520,603004,639524,7445,10,493,140,4127,464,27093,37,2429,533,6
6/15/2020,31099,712,30886,699,213,13,35871,596208,632079,10494,8,483,18,3987,686,26629,37,2392,527,15
6/14/2020,30387,607,30187,603,200,4,35064,586521,621585,13783,3,475,258,3969,346,25943,26,2355,512,9
6/13/2020,29780,541,29584,536,196,5,34325,573477,607802,10693,4,472,157,3711,380,25597,21,2329,503,7
6/12/2020,29239,546,29048,543,191,3,33593,563516,597109,9630,27,468,-43,3554,562,25217,31,2308,496,4
6/11/2020,28693,615,28505,612,188,3,32971,554508,587479,9565,5,441,-160,3597,770,24655,26,2277,492,5
6/10/2020,28078,427,27893,422,185,5,32272,545642,577914,8283,1,436,-181,3757,607,23885,40,2251,487,1
6/9/2020,27651,585,27471,580,180,5,31900,537731,569631,9619,14,435,-52,3938,623,23278,38,2211,486,4
6/8/2020,27066,489,26891,485,175,4,31226,528786,560012,9954,3,421,99,3990,387,22655,27,2173,482,5
6/7/2020,26577,428,26406,426,171,2,30670,519388,550058,13954,1,418,157,3891,270,22268,22,2146,477,5
6/6/2020,26149,471,25980,468,169,3,30046,506058,536104,10914,9,417,189,3734,273,21998,21,2124,472,10
6/5/2020,25678,511,25512,502,166,9,29483,495707,525190,11827,7,408,8,3545,496,21725,20,2103,462,6
6/4/2020,25167,227,25010,224,157,3,28871,484492,513363,5699,13,401,-266,3537,480,21229,19,2083,456,3
6/3/2020,24940,357,24786,356,154,1,28656,479008,507664,7923,7,388,-156,3803,506,20749,33,2064,453,8
6/2/2020,24583,651,24430,648,153,3,28239,471502,499741,14413,14,381,197,3959,440,20243,29,2031,445,7
6/1/2020,23932,605,23782,601,150,4,27416,457912,485328,10438,3,367,-107,3762,709,19803,16,2002,438,6
5/31/2020,23327,610,23181,608,146,2,26649,448241,474890,15605,0,364,395,3869,215,19094,44,1986,432,5
5/30/2020,22717,461,22573,460,144,1,25944,433341,459285,9727,4,364,164,3474,293,18879,21,1942,427,10
5/29/2020,22256,231,22113,228,143,3,25375,424183,449558,7116,4,360,-170,3310,397,18586,14,1921,417,7
5/28/2020,22025,599,21885,598,140,1,25111,417331,442442,9271,3,356,221,3480,375,18189,31,1907,410,4
5/27/2020,21426,216,21287,210,139,6,24439,408732,433171,6556,10,353,-126,3259,332,17814,26,1876,406,7
5/26/2020,21210,356,21077,346,133,10,24247,402368,426615,7018,5,343,-34,3385,385,17482,20,1850,399,4
5/25/2020,20854,601,20731,600,123,1,23846,395751,419597,11221,2,338,251,3419,348,17097,27,1830,395,6
5/24/2020,20253,331,20131,331,122,0,23135,385241,408376,11951,7,336,120,3168,204,16749,17,1803,389,10
5/23/2020,19922,421,19800,416,122,5,22718,373707,396425,11358,14,329,240,3048,167,16545,20,1786,379,6
5/22/2020,19501,385,19384,381,117,4,22155,362912,385067,8792,2,315,85,2808,298,16378,28,1766,373,3
5/21/2020,19116,385,19003,384,113,1,21731,354544,376275,6762,4,313,-255,2723,636,16080,15,1738,370,8
5/20/2020,18731,259,18619,258,112,1,21342,348171,369513,8511,4,309,-314,2978,569,15444,17,1723,362,5
5/19/2020,18472,335,18361,334,111,1,21026,339976,361002,6568,4,305,-98,3292,429,14875,25,1706,357,2
5/18/2020,18137,343,18027,341,110,2,20636,333798,354434,8928,3,301,0,3390,340,14446,22,1681,355,4
5/17/2020,17794,472,17686,472,108,0,20217,325289,345506,14063,3,298,305,3390,164,14106,21,1659,351,7
5/16/2020,17322,261,17214,244,108,17,19622,311821,331443,11075,5,295,44,3085,212,13942,17,1638,344,6
5/15/2020,17061,193,16970,191,91,2,19241,301127,320368,8254,3,290,-197,3041,387,13730,9,1621,338,8
5/14/2020,16868,264,16779,263,89,1,19022,293092,312114,10199,14,287,-117,3238,367,13343,14,1612,330,15
5/13/2020,16604,322,16516,319,88,3,18671,283244,301915,10053,9,273,-494,3355,807,12976,27,1598,315,11
5/12/2020,16282,697,16197,697,85,0,18289,273573,291862,14881,13,264,-411,3849,1095,12169,22,1571,304,8
5/11/2020,15585,555,15500,552,85,3,17473,259508,276981,9909,8,251,178,4260,369,11074,20,1549,296,4
5/10/2020,15030,247,14948,244,82,3,16899,250173,267072,10158,1,243,64,4082,182,10705,10,1529,292,4
5/9/2020,14783,246,14704,244,79,2,16539,240375,256914,9840,1,242,10,4018,235,10523,13,1519,288,8
5/8/2020,14537,195,14460,194,77,1,16213,230861,247074,6610,4,241,-198,4008,389,10288,12,1506,280,6
5/7/2020,14342,392,14266,390,76,2,15965,224499,240464,10766,-2,237,79,4206,315,9899,23,1494,274,8
5/6/2020,13950,260,13876,260,74,0,15501,214197,229698,5908,13,239,-92,4127,339,9584,13,1471,266,3
5/5/2020,13690,189,13616,188,74,1,15182,208608,223790,7847,7,226,-141,4219,323,9245,24,1458,263,10
5/4/2020,13501,312,13428,308,73,4,14937,201006,215943,7109,9,219,-306,4360,609,8922,20,1434,253,6
5/3/2020,13189,371,13120,365,69,6,14576,194258,208834,9463,1,210,119,4666,251,8313,25,1414,247,9
5/2/2020,12818,238,12755,237,63,1,14138,185233,199371,7038,5,209,-100,4547,333,8062,18,1389,238,5
5/1/2020,12580,769,12518,764,62,5,13785,178548,192333,9537,5,204,469,4647,295,7729,17,1371,233,5
4/30/2020,11811,1002,11754,998,57,4,12973,169823,182796,5068,4,199,779,4178,219,7434,31,1354,228,5
4/29/2020,10809,568,10756,566,53,2,11942,165786,177728,11063,7,195,331,3399,230,7215,30,1323,223,5
4/28/2020,10241,274,10190,270,51,4,11269,155396,166665,6579,4,188,40,3068,230,6985,32,1293,218,6
4/27/2020,9967,297,9920,293,47,4,10961,149125,160086,5431,3,184,-14,3028,308,6755,35,1261,212,5
4/26/2020,9670,298,9627,297,43,1,10642,144013,154655,6632,3,181,139,3042,156,6447,17,1226,207,4
4/25/2020,9372,302,9330,297,42,5,10293,137730,148023,4513,10,178,132,2903,160,6291,22,1209,203,6
4/24/2020,9070,469,9033,460,37,9,9952,133558,143510,16140,-2,168,247,2771,224,6131,40,1187,197,5
4/23/2020,8601,452,8573,450,28,2,9277,118093,127370,5114,4,170,300,2524,148,5907,17,1147,192,10
4/22/2020,8149,499,8123,497,26,2,8792,113464,122256,8908,9,166,281,2224,209,5759,18,1130,182,3
4/21/2020,7650,288,7626,286,24,2,8254,105094,113348,6864,5,157,96,1943,187,5550,24,1112,179,5
4/20/2020,7362,251,7340,243,22,8,7922,98562,106484,6546,4,152,27,1847,220,5363,27,1088,174,4
4/19/2020,7111,276,7097,276,14,0,7663,92275,99938,5187,3,148,151,1820,122,5143,10,1061,170,3
4/18/2020,6835,173,6821,173,14,0,7340,87411,94751,5268,3,145,8,1669,162,5021,11,1051,167,2
4/17/2020,6662,320,6648,319,14,1,7058,82425,89483,3269,1,142,125,1661,194,4859,30,1040,165,3
4/16/2020,6342,291,6329,291,13,0,6693,79521,86214,4202,6,141,80,1536,205,4665,23,1010,162,6
4/15/2020,6051,263,6038,263,13,0,6279,75733,82012,3097,11,135,20,1456,232,4460,18,987,156,6
4/14/2020,5788,182,5775,182,13,0,5974,72941,78915,1794,15,124,-48,1436,215,4228,29,969,150,10
4/13/2020,5606,217,5593,216,13,1,5737,71384,77121,4720,8,109,-9,1484,218,4013,38,940,140,8
4/12/2020,5389,224,5377,222,12,2,5441,66960,72401,4865,0,101,82,1493,142,3795,32,902,132,8
4/11/2020,5165,292,5155,292,10,0,5205,62331,67536,5182,3,101,26,1411,263,3653,42,870,124,7
4/10/2020,4873,195,4863,194,10,1,4809,57545,62354,2323,4,98,-29,1385,220,3390,22,828,117,2
4/9/2020,4678,280,4669,280,9,0,4632,55399,60031,3304,15,94,52,1414,213,3170,42,806,115,5
4/8/2020,4398,205,4389,205,9,0,4345,52382,56727,2636,7,79,-46,1362,244,2957,30,764,110,16
4/7/2020,4193,305,4184,305,9,0,4131,49960,54091,4634,7,72,59,1408,239,2713,43,734,94,7
4/6/2020,3888,228,3879,228,9,0,3814,45643,49457,3647,21,65,-71,1349,278,2474,47,691,87,7
4/5/2020,3660,312,3651,311,9,1,3581,42229,45810,3597,1,44,127,1420,184,2196,46,644,80,10
4/4/2020,3348,201,3340,201,8,0,3253,38960,42213,3560,6,43,-14,1293,209,2012,26,598,70,4
4/3/2020,3147,253,3139,252,8,1,3037,35616,38653,2488,5,37,4,1307,244,1803,42,572,66,16
4/2/2020,2894,270,2887,270,7,0,2798,33367,36165,3886,8,32,37,1303,225,1559,58,530,50,6
4/1/2020,2624,357,2617,357,7,0,2497,29782,32279,3363,1,24,134,1266,222,1334,58,472,44,8
3/31/2020,2267,287,2260,287,7,0,2154,26762,28916,3017,10,23,70,1132,207,1112,46,414,36,8
3/30/2020,1980,439,1973,439,7,0,1845,24054,25899,4738,6,13,226,1062,207,905,83,368,28,6
3/29/2020,1541,102,1534,102,7,0,1422,19739,21161,652,1,7,-47,836,148,698,35,285,22,6
3/28/2020,1439,196,1432,191,7,5,1338,19171,20509,2309,0,6,89,883,107,550,39,250,16,4
3/27/2020,1243,207,1241,207,2,0,1150,17050,18200,2577,3,6,96,794,108,443,42,211,12,2
3/26/2020,1036,167,1034,166,2,1,961,14662,15623,2849,0,3,84,698,83,335,30,169,10,4
3/25/2020,869,157,868,157,1,0,794,11980,12774,2037,1,3,78,614,78,252,35,139,6,1
3/24/2020,712,85,711,85,1,0,663,10074,10737,1119,0,2,30,536,55,174,21,104,5,1
3/23/2020,627,122,626,122,1,0,594,9024,9618,1573,0,2,84,506,38,119,13,83,4,0
3/22/2020,505,133,504,132,1,1,478,7567,8045,1485,1,2,108,422,24,81,27,70,4,1
3/21/2020,372,151,372,151,0,0,390,6170,6560,2090,1,1,121,314,29,57,14,43,3,2
3/20/2020,221,162,221,162,0,0,243,4227,4470,1080,0,0,142,193,20,28,14,29,1,1
3/19/2020,59,30,59,30,0,0,176,3214,3390,832,0,0,22,51,8,8,9,15,0,0
3/18/2020,29,11,29,11,0,0,116,2442,2558,591,0,0,11,29,0,0,3,6,0,0
3/17/2020,18,4,18,4,0,0,82,1885,1967,1360,0,0,4,18,0,0,0,3,0,0
3/16/2020,14,4,14,4,0,0,24,583,607,159,0,0,4,14,0,0,2,3,0,0
3/15/2020,10,4,10,4,0,0,21,427,448,28,0,0,4,10,0,0,0,1,0,0
3/14/2020,6,5,6,5,0,0,19,401,420,333,0,0,5,6,0,0,1,1,0,0
3/13/2020,1,0,1,0,0,0,2,85,87,42,0,0,0,1,0,0,0,0,0,0
3/12/2020,1,1,1,1,0,0,2,43,45,45,0,0,1,1,0,0,0,0,0,0
