DATE,TOTAL_CASES,NEW_CASES,TOTAL_CONFIRMED,NEW_CONFIRMED,TOTAL_PROBABLE,NEW_PROBABLE,POS_TESTS,NEG_TESTS,TOTAL_TESTS,NEW_TESTS,NEW_DEATHS,TOTAL_DEATHS,NEW_ACTIVE,TOTAL_ACTIVE,NEW_INACTIVE_RECOVERED,TOTAL_INACTIVE_RECOVERED,NEW_HOSP,TOTAL_HOSP,TOTAL_DEATHS_BY_DOD,NEW_DEATHS_BY_DOD
9/16/2021,1178168,6474,932567,4656,245601,1818,1066391,8562394,9628785,28367,52,14341,-1842,71331,8264,1092496,11,32421,14332,8
9/15/2021,1171694,4593,927911,2911,243783,1682,1061253,8539165,9600418,16986,65,14289,-4129,73173,8657,1084232,19,32410,14324,29
9/14/2021,1167101,7417,925000,4985,242101,2432,1058020,8525412,9583432,28526,87,14224,-2405,77302,9735,1075575,21,32391,14295,37
9/13/2021,1159684,5685,920015,3373,239669,2312,1052382,8502524,9554906,20461,128,14137,-5864,79707,11421,1065840,30,32370,14258,50
9/12/2021,1153999,3451,916642,2896,237357,555,1048636,8485809,9534445,18656,34,14009,-508,85571,3925,1054419,4,32340,14208,31
9/11/2021,1150548,11325,913746,8190,236802,3135,1045344,8470445,9515789,50073,28,13975,6963,86079,4334,1050494,27,32336,14177,42
9/10/2021,1139223,15104,905556,10628,233667,4476,1036183,8429533,9465716,60492,58,13947,6607,79116,8439,1046160,57,32309,14135,28
9/9/2021,1124119,5173,894928,2832,229191,2341,1024308,8380916,9405224,16930,11,13889,-4502,72509,9664,1037721,17,32252,14107,34
9/8/2021,1118946,4493,892096,3193,226850,1300,1021190,8367104,9388294,16634,75,13878,-4999,77011,9417,1028057,39,32235,14073,33
9/7/2021,1114453,5350,888903,3618,225550,1732,1017649,8354011,9371660,18965,85,13803,-5525,82010,10790,1018640,40,32196,14040,29
9/6/2021,1109103,13089,885285,10451,223818,2638,1013657,8339038,9352695,64397,24,13718,2337,87535,10728,1007850,51,32156,14011,40
9/5/2021,1096014,11400,874834,8045,221180,3355,1001924,8286374,9288298,50049,11,13694,7535,85198,3854,997122,30,32105,13971,44
9/4/2021,1084614,9051,866789,6506,217825,2545,993015,8245234,9238249,39238,14,13683,4665,77663,4372,993268,35,32075,13927,39
9/3/2021,1075563,4792,860283,3304,215280,1488,985677,8213334,9199011,16828,41,13669,-2769,72998,7520,988896,36,32040,13888,33
9/2/2021,1070771,6565,856979,4250,213792,2315,982019,8200164,9182183,21729,75,13628,-1694,75767,8184,981376,60,32004,13855,46
9/1/2021,1064206,3290,852729,2031,211477,1259,977357,8183097,9160454,8666,36,13553,-3899,77461,7153,973192,40,31944,13809,51
8/31/2021,1060916,9440,850698,6183,210218,3257,975200,8176588,9151788,35325,32,13517,1167,81360,8241,966039,146,31904,13758,52
8/30/2021,1051476,9875,844515,7459,206961,2416,968341,8148122,9116463,43400,57,13485,1702,80193,8116,957798,118,31758,13706,45
8/29/2021,1041601,6473,837056,5242,204545,1231,960023,8113040,9073063,30916,21,13428,3297,78491,3155,949682,93,31640,13661,38
8/28/2021,1035128,6189,831814,4408,203314,1781,954186,8087961,9042147,25327,16,13407,2850,75194,3323,946527,73,31547,13623,42
8/27/2021,1028939,7869,827406,6020,201533,1849,949325,8067495,9016820,31848,51,13391,2749,72344,5069,943204,81,31474,13581,42
8/26/2021,1021070,7476,821386,4956,199684,2520,942856,8042116,8984972,30194,40,13340,1776,69595,5660,938135,86,31393,13539,37
8/25/2021,1013594,6576,816430,3719,197164,2857,937386,8017392,8954778,20594,49,13300,1496,67819,5031,932475,83,31307,13502,50
8/24/2021,1007018,4583,812711,3093,194307,1490,933373,8000811,8934184,15490,23,13251,-984,66323,5544,927444,68,31224,13452,37
8/23/2021,1002435,5154,809618,2870,192817,2284,930028,7988666,8918694,15836,32,13228,-420,67307,5542,921900,67,31156,13415,27
8/22/2021,997281,4059,806748,3767,190533,292,926916,7975942,8902858,23265,25,13196,1373,67727,2661,916358,43,31089,13388,32
8/21/2021,993222,9807,802981,6805,190241,3002,922653,7956940,8879593,42193,12,13171,7289,66354,2506,913697,95,31046,13356,29
8/20/2021,983415,6390,796176,4973,187239,1417,915172,7922228,8837400,27837,25,13159,2634,59065,3731,911191,76,30951,13327,46
8/19/2021,977025,7144,791203,4491,185822,2653,909837,7899726,8809563,31999,46,13134,2967,56431,4131,907460,74,30875,13281,35
8/18/2021,969881,6524,786712,4353,183169,2171,904963,7872601,8777564,27181,51,13088,2854,53464,3619,903329,65,30801,13246,35
8/17/2021,963357,5404,782359,3891,180998,1513,900090,7850293,8750383,24063,27,13037,1536,50610,3841,899710,52,30736,13211,37
8/16/2021,957953,3707,778468,2285,179485,1422,895717,7830603,8726320,13985,32,13010,-159,49074,3834,895869,58,30684,13174,26
8/15/2021,954246,2779,776183,2295,178063,484,893167,7819168,8712335,14044,19,12978,761,49233,1999,892035,30,30626,13148,25
8/14/2021,951467,4868,773888,3658,177579,1210,890541,7807750,8698291,24156,4,12959,2983,48472,1881,890036,54,30596,13123,29
8/13/2021,946599,5549,770230,3964,176369,1585,886387,7787748,8674135,25887,22,12955,2848,45489,2679,888155,65,30542,13094,34
8/12/2021,941050,4615,766266,3498,174784,1117,881990,7766258,8648248,22313,29,12933,1784,42641,2802,885476,102,30477,13060,24
8/11/2021,936435,5601,762768,3892,173667,1709,878070,7747865,8625935,25841,20,12904,2935,40857,2646,882674,147,30375,13036,23
8/10/2021,930834,4091,758876,2595,171958,1496,873799,7726295,8600094,16273,7,12884,1560,37922,2524,880028,95,30228,13013,19
8/9/2021,926743,3641,756281,2329,170462,1312,870910,7712911,8583821,13625,41,12877,1177,36362,2423,877504,102,30133,12994,30
8/8/2021,923102,2159,753952,1589,169150,570,868340,7701856,8570196,11105,6,12836,896,35185,1257,875081,67,30031,12964,26
8/7/2021,920943,2590,752363,1987,168580,603,866488,7692603,8559091,14497,3,12830,1286,34289,1301,873824,69,29964,12938,21
8/6/2021,918353,4533,750376,3221,167977,1312,864199,7680395,8544594,21574,8,12827,2955,33003,1570,872523,117,29895,12917,27
8/5/2021,913820,3924,747155,2929,166665,995,860615,7662405,8523020,20140,29,12819,2323,30048,1572,870953,96,29778,12890,10
8/4/2021,909896,3245,744226,2499,165670,746,857360,7645520,8502880,17688,15,12790,1748,27725,1482,869381,105,29682,12880,8
8/3/2021,906651,3749,741727,2614,164924,1135,854556,7630636,8485192,17479,9,12775,2375,25977,1365,867899,98,29577,12872,17
8/2/2021,902902,2694,739113,1791,163789,903,851684,7616029,8467713,11337,16,12766,1292,23602,1386,866534,101,29479,12855,15
8/1/2021,900208,1693,737322,1339,162886,354,849743,7606633,8456376,9802,9,12750,948,22310,736,865148,67,29378,12840,10
7/31/2021,898515,2033,735983,1503,162532,530,848229,7598345,8446574,11003,9,12741,1318,21362,706,864412,86,29311,12830,16
7/30/2021,896482,3102,734480,2386,162002,716,846533,7589038,8435571,16384,8,12732,2263,20044,831,863706,95,29225,12814,7
7/29/2021,893380,2310,732094,1629,161286,681,843915,7575272,8419187,12932,2,12724,1557,17781,751,862875,61,29130,12807,13
7/28/2021,891070,2668,730465,1889,160605,779,842160,7564095,8406255,14876,8,12722,1833,16224,827,862124,81,29069,12794,11
7/27/2021,888402,2273,728576,1466,159826,807,840090,7551289,8391379,11507,12,12714,1544,14391,717,861297,71,28988,12783,15
7/26/2021,886129,2125,727110,1369,159019,756,838491,7541381,8379872,9639,20,12702,1370,12847,735,860580,94,28917,12768,11
7/25/2021,884004,864,725741,718,158263,146,837035,7533198,8370233,6236,11,12682,397,11477,456,859845,26,28823,12757,11
7/24/2021,883140,1269,725023,918,158117,351,836243,7527754,8363997,8409,3,12671,770,11080,496,859389,53,28797,12746,7
7/23/2021,881871,1561,724105,1093,157766,468,835221,7520367,8355588,10510,3,12668,1045,10310,513,858893,63,28744,12739,18
7/22/2021,880310,1544,723012,1089,157298,455,834043,7511035,8345078,11779,7,12665,1007,9265,530,858380,60,28681,12721,7
7/21/2021,878766,1449,721923,1011,156843,438,832827,7500472,8333299,10144,15,12658,885,8258,549,857850,63,28621,12714,11
7/20/2021,877317,1280,720912,889,156405,391,831768,7491387,8323155,10011,4,12643,782,7373,494,857301,58,28558,12703,7
7/19/2021,876037,973,720023,624,156014,349,830784,7482360,8313144,7036,9,12639,538,6591,426,856807,44,28500,12696,5
7/18/2021,875064,477,719399,367,155665,110,830108,7476000,8306108,4717,1,12630,205,6053,271,856381,20,28456,12691,8
7/17/2021,874587,623,719032,445,155555,178,829690,7471701,8301391,6028,2,12629,287,5848,334,856110,31,28436,12683,3
7/16/2021,873964,785,718587,549,155377,236,829190,7466173,8295363,7978,2,12627,492,5561,291,855776,49,28405,12680,7
7/15/2021,873179,791,718038,568,155141,223,828584,7458801,8287385,8707,5,12625,453,5069,333,855485,39,28356,12673,4
7/14/2021,872388,709,717470,524,154918,185,827967,7450711,8278678,8717,4,12620,428,4616,277,855152,23,28317,12669,3
7/13/2021,871679,805,716946,512,154733,293,827413,7442548,8269961,8125,9,12616,525,4188,271,854875,44,28294,12666,7
7/12/2021,870874,583,716434,380,154440,203,826859,7434977,8261836,5756,10,12607,287,3663,286,854604,28,28250,12659,6
7/11/2021,870291,229,716054,198,154237,31,826451,7429629,8256080,3562,8,12597,57,3376,164,854318,26,28222,12653,4
7/10/2021,870062,411,715856,294,154206,117,826211,7426307,8252518,5363,0,12589,258,3319,153,854154,29,28196,12649,5
7/9/2021,869651,564,715562,414,154089,150,825892,7421263,8247155,8278,5,12589,364,3061,195,854001,29,28167,12644,5
7/8/2021,869087,559,715148,400,153939,159,825447,7413430,8238877,8314,4,12584,378,2697,177,853806,16,28138,12639,3
7/7/2021,868528,500,714748,341,153780,159,825019,7405544,8230563,7941,9,12580,318,2319,173,853629,17,28122,12636,6
7/6/2021,868028,426,714407,278,153621,148,824649,7397973,8222622,5846,6,12571,225,2001,195,853456,18,28105,12630,3
7/5/2021,867602,191,714129,106,153473,85,824339,7392437,8216776,2627,1,12565,1,1776,189,853261,15,28087,12627,2
7/4/2021,867411,179,714023,138,153388,41,824219,7389930,8214149,3223,0,12564,60,1775,119,853072,6,28072,12625,3
7/3/2021,867232,265,713885,183,153347,82,824066,7386860,8210926,4827,3,12564,126,1715,136,852953,19,28066,12622,6
7/2/2021,866967,318,713702,211,153265,107,823855,7382244,8206099,6602,2,12561,168,1589,148,852817,12,28047,12616,4
7/1/2021,866649,303,713491,194,153158,109,823612,7375885,8199497,8127,3,12559,147,1421,153,852669,11,28035,12612,6
6/30/2021,866346,302,713297,227,153049,75,823378,7367992,8191370,7416,6,12556,133,1274,163,852516,16,28024,12606,4
6/29/2021,866044,413,713070,252,152974,161,823122,7360832,8183954,9326,-2,12550,262,1141,153,852353,17,28008,12602,4
6/28/2021,865631,110,712818,75,152813,35,822841,7351787,8174628,3392,7,12552,-87,879,190,852200,4,27991,12598,1
6/27/2021,865521,96,712743,62,152778,34,822758,7348478,8171236,3206,4,12545,-11,966,103,852010,3,27987,12597,3
6/26/2021,865425,128,712681,89,152744,39,822691,7345339,8168030,5479,3,12541,2,977,123,851907,7,27984,12594,3
6/25/2021,865297,216,712592,158,152705,58,822590,7339961,8162551,7524,0,12538,87,975,129,851784,11,27977,12591,7
6/24/2021,865081,220,712434,153,152647,67,822401,7332626,8155027,7654,7,12538,34,888,179,851655,19,27966,12584,4
6/23/2021,864861,231,712281,171,152580,60,822213,7325160,8147373,8707,4,12531,25,854,202,851476,13,27947,12580,7
6/22/2021,864630,234,712110,128,152520,106,822006,7316660,8138666,7449,5,12527,80,829,149,851274,16,27934,12573,5
6/21/2021,864396,155,711982,102,152414,53,821863,7309354,8131217,5768,10,12522,-80,749,225,851125,10,27918,12568,3
6/20/2021,864241,84,711880,65,152361,19,821721,7303728,8125449,3287,3,12512,-38,829,119,850900,5,27908,12565,4
6/19/2021,864157,127,711815,75,152342,52,821653,7300509,8122162,5548,3,12509,-54,867,178,850781,10,27903,12561,6
6/18/2021,864030,183,711740,142,152290,41,821558,7295056,8116614,7500,2,12506,-23,921,204,850603,9,27893,12555,7
6/17/2021,863847,169,711598,125,152249,44,821392,7287722,8109114,9333,3,12504,-51,944,217,850399,1,27884,12548,4
6/16/2021,863678,266,711473,210,152205,56,821239,7278542,8099781,9424,7,12501,28,995,231,850182,9,27883,12544,4
6/15/2021,863412,307,711263,205,152149,102,820998,7269359,8090357,8675,2,12494,-38,967,343,849951,11,27874,12540,5
6/14/2021,863105,214,711058,119,152047,95,820750,7260932,8081682,6458,5,12492,23,1005,186,849608,15,27863,12535,2
6/13/2021,862891,83,710939,67,151952,16,820595,7254629,8075224,3459,3,12487,-98,982,178,849422,6,27848,12533,3
6/12/2021,862808,149,710872,94,151936,55,820505,7251260,8071765,5821,0,12484,-26,1080,175,849244,11,27842,12530,6
6/11/2021,862659,288,710778,155,151881,133,820391,7245553,8065944,7401,-2,12484,46,1106,244,849069,18,27831,12524,6
6/10/2021,862371,235,710623,171,151748,64,820204,7238339,8058543,8589,3,12486,-56,1060,288,848825,11,27813,12518,6
6/9/2021,862136,214,710452,150,151684,64,819996,7229958,8049954,10846,2,12483,-78,1116,290,848537,11,27802,12512,4
6/8/2021,861922,270,710302,176,151620,94,819803,7219305,8039108,7504,2,12481,-80,1194,348,848247,20,27791,12508,7
6/7/2021,861652,262,710126,151,151526,111,819599,7212005,8031604,6028,13,12479,-153,1274,402,847899,24,27771,12501,2
6/6/2021,861390,101,709975,80,151415,21,819393,7206183,8025576,4272,-1,12466,-147,1427,249,847497,7,27747,12499,1
6/5/2021,861289,165,709895,114,151394,51,819301,7202003,8021304,5973,3,12467,-167,1574,329,847248,14,27740,12498,7
6/4/2021,861124,292,709781,199,151343,93,819170,7196161,8015331,9694,1,12464,-99,1741,390,846919,14,27726,12491,2
6/3/2021,860832,318,709582,220,151250,98,818916,7186721,8005637,11730,5,12463,-108,1840,421,846529,19,27712,12489,4
6/2/2021,860514,361,709362,249,151152,112,818593,7175314,7993907,9573,7,12458,-93,1948,447,846108,20,27693,12485,7
6/1/2021,860153,420,709113,276,151040,144,818311,7166023,7984334,6864,9,12451,-61,2041,472,845661,30,27673,12478,3
5/31/2021,859733,187,708837,129,150896,58,818005,7159465,7977470,4044,11,12442,-373,2102,549,845189,11,27643,12475,6
5/30/2021,859546,180,708708,129,150838,51,817848,7155578,7973426,4773,0,12431,-213,2475,393,844640,15,27632,12469,6
5/29/2021,859366,189,708579,134,150787,55,817693,7150960,7968653,5758,2,12431,-250,2688,437,844247,19,27617,12463,3
5/28/2021,859177,317,708445,244,150732,73,817501,7145394,7962895,9595,3,12429,-165,2938,479,843810,13,27598,12460,7
5/27/2021,858860,396,708201,266,150659,130,817214,7136086,7953300,10623,12,12426,-228,3103,612,843331,21,27585,12453,7
5/26/2021,858464,498,707935,365,150529,133,816835,7125842,7942677,12268,23,12414,-112,3331,587,842719,37,27564,12446,8
5/25/2021,857966,419,707570,281,150396,138,816406,7114003,7930409,9200,6,12391,-201,3443,614,842132,23,27527,12438,9
5/24/2021,857547,452,707289,314,150258,138,816115,7105094,7921209,7768,7,12385,-297,3644,742,841518,28,27504,12429,3
5/23/2021,857095,252,706975,187,150120,65,815760,7097681,7913441,5363,6,12378,-273,3941,519,840776,15,27476,12426,8
5/22/2021,856843,309,706788,230,150055,79,815528,7092550,7908078,7446,3,12372,-176,4214,482,840257,22,27461,12418,4
5/21/2021,856534,516,706558,345,149976,171,815230,7085402,7900632,10299,4,12369,-133,4390,645,839775,21,27439,12414,9
5/20/2021,856018,546,706213,389,149805,157,814828,7075505,7890333,24051,16,12365,-209,4523,739,839130,33,27418,12405,11
5/19/2021,855472,630,705824,462,149648,168,814360,7051922,7866282,13914,11,12349,-161,4732,780,838391,37,27385,12394,10
5/18/2021,854842,572,705362,390,149480,182,813826,7038542,7852368,10686,14,12338,-274,4893,832,837611,36,27348,12384,7
5/17/2021,854270,659,704972,394,149298,265,813386,7028296,7841682,9115,12,12324,-317,5167,964,836779,30,27312,12377,10
5/16/2021,853611,275,704578,201,149033,74,812930,7019637,7832567,5278,4,12312,-304,5484,575,835815,19,27282,12367,10
5/15/2021,853336,402,704377,293,148959,109,812679,7014610,7827289,8538,1,12308,-244,5788,645,835240,22,27263,12357,7
5/14/2021,852934,802,704084,588,148850,214,812303,7006448,7818751,12109,10,12307,61,6032,731,834595,47,27241,12350,12
5/13/2021,852132,709,703496,479,148636,230,811624,6995018,7806642,12388,7,12297,-157,5971,859,833864,33,27194,12338,6
5/12/2021,851423,897,703017,652,148406,245,811076,6983178,7794254,17155,9,12290,-89,6128,977,833005,49,27161,12332,11
5/11/2021,850526,844,702365,613,148161,231,810276,6966823,7777099,11523,4,12281,-195,6217,1035,832028,44,27112,12321,6
5/10/2021,849682,626,701752,383,147930,243,809622,6955954,7765576,7511,17,12277,-638,6412,1247,830993,53,27068,12315,10
5/9/2021,849056,376,701369,284,147687,92,809189,6948876,7758065,6854,19,12260,-364,7050,721,829746,26,27015,12305,8
5/8/2021,848680,559,701085,399,147595,160,808854,6942357,7751211,10159,0,12241,-104,7414,663,829025,27,26989,12297,10
5/7/2021,848121,1030,700686,740,147435,290,808357,6932695,7741052,15082,2,12241,57,7518,971,828362,48,26962,12287,8
5/6/2021,847091,789,699946,547,147145,242,807502,6918468,7725970,11570,11,12239,-289,7461,1067,827391,35,26914,12279,13
5/5/2021,846302,1207,699399,766,146903,441,806866,6907534,7714400,17609,16,12228,233,7750,958,826324,49,26879,12266,12
5/4/2021,845095,852,698633,602,146462,250,805998,6890793,7696791,12118,11,12212,-260,7517,1101,825366,38,26830,12254,9
5/3/2021,844243,655,698031,453,146212,202,805307,6879366,7684673,8324,13,12201,-552,7777,1194,824265,41,26792,12245,6
5/2/2021,843588,498,697578,375,146010,123,804784,6871565,7676349,7405,1,12188,-221,8329,718,823071,27,26751,12239,12
5/1/2021,843090,609,697203,449,145887,160,804344,6864600,7668944,10381,-1,12187,-170,8550,780,822353,34,26724,12227,7
4/30/2021,842481,1070,696754,772,145727,298,803856,6854707,7658563,14996,7,12188,19,8720,1044,821573,39,26690,12220,10
4/29/2021,841411,1029,695982,693,145429,336,802986,6840581,7643567,14644,9,12181,-50,8701,1070,820529,43,26651,12210,10
4/28/2021,840382,1193,695289,862,145093,331,802204,6826719,7628923,20550,17,12172,-12,8751,1188,819459,57,26608,12200,9
4/27/2021,839189,1157,694427,711,144762,446,801208,6807165,7608373,13763,8,12155,-50,8763,1199,818271,58,26551,12191,12
4/26/2021,838032,1091,693716,714,144316,377,800410,6794200,7594610,9830,11,12147,-366,8813,1446,817072,44,26493,12179,11
4/25/2021,836941,554,693002,426,143939,128,799628,6785152,7584780,8198,6,12136,-285,9179,833,815626,35,26449,12168,7
4/24/2021,836387,752,692576,567,143811,185,799127,6777455,7576582,13085,0,12130,-210,9464,962,814793,49,26414,12161,7
4/23/2021,835635,952,692009,690,143626,262,798471,6765026,7563497,14914,4,12130,-222,9674,1170,813831,39,26365,12154,5
4/22/2021,834683,1851,691319,1053,143364,798,797634,6750949,7548583,22069,12,12126,605,9896,1234,812661,63,26326,12149,12
4/21/2021,832832,1377,690266,940,142566,437,796447,6730067,7526514,17939,19,12114,90,9291,1268,811427,51,26263,12137,15
4/20/2021,831455,1092,689326,900,142129,192,795392,6713183,7508575,13967,15,12095,-248,9201,1325,810159,68,26212,12122,8
4/19/2021,830363,841,688426,552,141937,289,794418,6700190,7494608,9227,15,12080,-658,9449,1484,808834,46,26144,12114,12
4/18/2021,829522,560,687874,478,141648,82,793807,6691574,7485381,8182,17,12065,-253,10107,796,807350,24,26098,12102,11
4/17/2021,828962,703,687396,572,141566,131,793241,6683958,7477199,11841,1,12048,-94,10360,796,806554,37,26074,12091,10
4/16/2021,828259,4211,686824,3996,141435,215,792565,6672793,7465358,35383,14,12047,3228,10454,969,805758,72,26037,12081,6
4/15/2021,824048,1375,682828,1000,141220,375,787940,6642035,7429975,18250,8,12033,174,7226,1193,804789,59,25965,12075,12
4/14/2021,822673,1801,681828,1342,140845,459,786846,6624879,7411725,24889,9,12025,653,7052,1139,803596,70,25906,12063,11
4/13/2021,820872,1131,680486,706,140386,425,785333,6601503,7386836,10998,10,12016,-103,6399,1224,802457,49,25836,12052,11
4/12/2021,819741,1231,679780,881,139961,350,784573,6591265,7375838,9294,7,12006,-81,6502,1305,801233,55,25787,12041,16
4/11/2021,818510,651,678899,459,139611,192,783596,6582948,7366544,7622,3,11999,-231,6583,879,799928,34,25732,12025,5
4/10/2021,817859,873,678440,607,139419,266,783083,6575839,7358922,12127,8,11996,40,6814,825,799049,55,25698,12020,10
4/9/2021,816986,1338,677833,1046,139153,292,782383,6564412,7346795,16594,3,11988,240,6774,1095,798224,67,25643,12010,13
4/8/2021,815648,1146,676787,780,138861,366,781197,6549004,7330201,15101,4,11985,-45,6534,1187,797129,45,25576,11997,5
4/7/2021,814502,1580,676007,1186,138495,394,780299,6534801,7315100,21197,21,11981,310,6579,1249,795942,63,25531,11992,8
4/6/2021,812922,1335,674821,885,138101,450,779010,6514893,7293903,14515,9,11960,48,6269,1278,794693,61,25468,11984,5
4/5/2021,811587,892,673936,519,137651,373,778017,6501371,7279388,6203,38,11951,-567,6221,1421,793415,69,25407,11979,10
4/4/2021,810695,551,673417,415,137278,136,777457,6495728,7273185,9631,7,11913,-298,6788,842,791994,28,25338,11969,16
4/3/2021,810144,895,673002,638,137142,257,776961,6486593,7263554,10441,0,11906,-23,7086,918,791152,32,25310,11953,15
4/2/2021,809249,1066,672364,813,136885,253,776241,6476872,7253113,14097,1,11906,-50,7109,1115,790234,39,25278,11938,11
4/1/2021,808183,1249,671551,900,136632,349,775299,6463717,7239016,14430,6,11905,-115,7159,1358,789119,40,25239,11927,7
3/31/2021,806934,1868,670651,1200,136283,668,774297,6450289,7224586,22675,11,11899,568,7274,1289,787761,55,25199,11920,11
3/30/2021,805066,1192,669451,879,135615,313,772941,6428970,7201911,14266,10,11888,-126,6706,1308,786472,63,25144,11909,10
3/29/2021,803874,1193,668572,620,135302,573,771925,6415720,7187645,8745,29,11878,-264,6832,1428,785164,47,25081,11899,6
3/28/2021,802681,814,667952,566,134729,248,771218,6407682,7178900,10847,13,11849,-118,7096,919,783736,40,25034,11893,8
3/27/2021,801867,814,667386,744,134481,70,770556,6397497,7168053,12899,11,11836,-56,7214,859,782817,34,24994,11885,9
3/26/2021,801053,994,666642,798,134411,196,769687,6385467,7155154,11801,25,11825,-322,7270,1291,781958,36,24960,11876,15
3/25/2021,800059,1145,665844,870,134215,275,768782,6374571,7143353,16421,20,11800,-192,7592,1317,780667,49,24924,11861,6
3/24/2021,798914,1608,664974,1278,133940,330,767790,6359142,7126932,21266,4,11780,277,7784,1327,779350,53,24875,11855,6
3/23/2021,797306,1170,663696,726,133610,444,766393,6339273,7105666,14738,45,11776,-182,7507,1307,778023,44,24822,11849,12
3/22/2021,796136,1265,662970,808,133166,457,765550,6325378,7090928,9623,34,11731,-107,7689,1338,776716,52,24778,11837,13
3/21/2021,794871,757,662162,565,132709,192,764655,6316650,7081305,8778,-8,11697,-26,7796,791,775378,22,24726,11824,13
3/20/2021,794114,753,661597,519,132517,234,764004,6308523,7072527,9860,4,11705,-49,7822,798,774587,23,24704,11811,7
3/19/2021,793361,1942,661078,1292,132283,650,763410,6299257,7062667,22151,28,11701,745,7871,1169,773789,62,24681,11804,11
3/18/2021,791419,1415,659786,973,131633,442,761983,6278533,7040516,18474,23,11673,264,7126,1128,772620,56,24619,11793,14
3/17/2021,790004,1071,658813,825,131191,246,760875,6261167,7022042,15727,8,11650,-86,6862,1149,771492,49,24563,11779,19
3/16/2021,788933,1936,657988,1250,130945,686,759951,6246364,7006315,18973,12,11642,715,6948,1209,770343,80,24514,11760,9
3/15/2021,786997,904,656738,503,130259,401,758523,6228819,6987342,5322,11,11630,-257,6233,1150,769134,34,24434,11751,8
3/14/2021,786093,661,656235,459,129858,202,757961,6224059,6982020,7936,0,11619,-100,6490,761,767984,24,24400,11743,16
3/13/2021,785432,1483,655776,801,129656,682,757420,6216664,6974084,16709,-12,11619,600,6590,895,767223,43,24376,11727,12
3/12/2021,783949,1111,654975,842,128974,269,756477,6200898,6957375,13678,16,11631,-26,5990,1121,766328,28,24333,11715,19
3/11/2021,782838,1362,654133,922,128705,440,755488,6188209,6943697,19466,17,11615,163,6016,1182,765207,31,24305,11696,12
3/10/2021,781476,1600,653211,1137,128265,463,754446,6169785,6924231,23674,18,11598,294,5853,1288,764025,47,24274,11684,25
3/9/2021,779876,1347,652074,804,127802,543,753168,6147389,6900557,17078,32,11580,-46,5559,1361,762737,38,24227,11659,21
3/8/2021,778529,1087,651270,678,127259,409,752237,6131242,6883479,7439,9,11548,-557,5605,1635,761376,26,24189,11638,26
3/7/2021,777442,752,650592,474,126850,278,751484,6124556,6876040,7157,4,11539,-200,6162,948,759741,14,24163,11612,22
3/6/2021,776690,1235,650118,845,126572,390,750932,6117951,6868883,18288,9,11535,167,6362,1059,758793,29,24149,11590,20
3/5/2021,775455,1226,649273,783,126182,443,749928,6100667,6850595,14126,33,11526,-71,6195,1264,757734,28,24120,11570,19
3/4/2021,774229,1608,648490,1067,125739,541,749025,6087444,6836469,25016,42,11493,569,6266,997,756470,38,24092,11551,18
3/3/2021,772621,1307,647423,887,125198,420,747790,6063663,6811453,18271,23,11451,16,5697,1268,755473,34,24054,11533,23
3/2/2021,771314,1549,646536,990,124778,559,746736,6046446,6793182,16049,15,11428,520,5681,1014,754205,45,24020,11510,11
3/1/2021,769765,567,645546,361,124219,206,745564,6031569,6777133,3756,10,11413,-434,5161,991,753191,26,23975,11499,14
2/28/2021,769198,840,645185,583,124013,257,745166,6028211,6773377,10304,18,11403,-73,5595,895,752200,20,23949,11485,13
2/27/2021,768358,1437,644602,856,123756,581,744475,6018598,6763073,17906,16,11385,376,5668,1045,751305,29,23929,11472,16
2/26/2021,766921,1123,643746,787,123175,336,743475,6001692,6745167,12039,56,11369,-571,5292,1638,750260,24,23900,11456,11
2/25/2021,765798,1681,642959,1178,122839,503,742549,5990579,6733128,22348,55,11313,-96,5863,1722,748622,52,23876,11445,23
2/24/2021,764117,1917,641781,1474,122336,443,741211,5969569,6710780,24493,68,11258,-48,5959,1897,746900,60,23824,11422,18
2/23/2021,762200,1845,640307,1135,121893,710,739524,5946763,6686287,17036,45,11190,-372,6007,2172,745003,60,23764,11404,21
2/22/2021,760355,1057,639172,604,121183,453,738258,5930993,6669251,6102,20,11145,-1282,6379,2319,742831,57,23704,11383,23
2/21/2021,759298,871,638568,583,120730,288,737567,5925582,6663149,6615,18,11125,-279,7661,1132,740512,32,23647,11360,30
2/20/2021,758427,1365,637985,837,120442,528,736889,5919645,6656534,12771,51,11107,-49,7940,1363,739380,50,23615,11330,20
2/19/2021,757062,997,637148,644,119914,353,735929,5907834,6643763,6593,7,11056,-925,7989,1915,738017,44,23565,11310,29
2/18/2021,756065,1483,636504,953,119561,530,735189,5901981,6637170,12970,72,11049,-654,8914,2065,736102,53,23521,11281,30
2/17/2021,754582,930,635551,596,119031,334,734115,5890085,6624200,6495,31,10977,-1312,9568,2211,734037,19,23468,11251,38
2/16/2021,753652,1230,634955,790,118697,440,733442,5884263,6617705,10030,17,10946,-1251,10880,2464,731826,41,23449,11213,31
2/15/2021,752422,777,634165,451,118257,326,732554,5875121,6607675,6251,4,10929,-2031,12131,2804,729362,19,23408,11182,26
2/14/2021,751645,1256,633714,901,117931,355,732021,5869403,6601424,12894,31,10925,-358,14162,1583,726558,30,23389,11156,31
2/13/2021,750389,1678,632813,1123,117576,555,731010,5857520,6588530,19309,9,10894,12,14520,1657,724975,45,23359,11125,33
2/12/2021,748711,1926,631690,1382,117021,544,729658,5839563,6569221,22223,81,10885,-405,14508,2250,723318,32,23314,11092,27
2/11/2021,746785,2417,630308,1739,116477,678,728057,5818941,6546998,25309,81,10804,-299,14913,2635,721068,56,23282,11065,34
2/10/2021,744368,2140,628569,1520,115799,620,726055,5795634,6521689,24642,100,10723,-588,15212,2628,718433,58,23226,11031,37
2/9/2021,742228,2692,627049,1776,115179,916,724286,5772761,6497047,21209,65,10623,-594,15800,3221,715805,75,23168,10994,40
2/8/2021,739536,1244,625273,783,114263,461,722243,5753595,6475838,6691,97,10558,-2340,16394,3487,712584,39,23093,10954,36
2/7/2021,738292,1354,624490,941,113802,413,721324,5747823,6469147,12999,6,10461,-439,18734,1787,709097,38,23054,10918,27
2/6/2021,736938,3660,623549,2598,113389,1062,720229,5735919,6456148,39268,58,10455,1585,19173,2017,707310,60,23016,10891,58
2/5/2021,733278,2185,620951,1572,112327,613,717096,5699784,6416880,21873,203,10397,-770,17588,2752,705293,61,22956,10833,49
2/4/2021,731093,2896,619379,2085,111714,811,715280,5679727,6395007,33113,169,10194,-533,18358,3260,702541,82,22895,10784,49
2/3/2021,728197,3345,617294,2261,110903,1084,712825,5649069,6361894,27650,133,10025,19,18891,3193,699281,96,22813,10735,40
2/2/2021,724852,1315,615033,842,109819,473,710238,5624006,6334244,6603,147,9892,-2902,18872,4070,696088,30,22717,10695,43
2/1/2021,723537,1689,614191,1058,109346,631,709321,5618320,6327641,8121,103,9745,-1893,21774,3479,692018,54,22687,10652,51
1/31/2021,721848,2174,613133,1387,108715,787,708172,5611348,6319520,16995,76,9642,-20,23667,2118,688539,53,22633,10601,48
1/30/2021,719674,3522,611746,2947,107928,575,706578,5595947,6302525,38421,113,9566,803,23687,2606,686421,54,22580,10553,50
1/29/2021,716152,1764,608799,1243,107353,521,703019,5561085,6264104,13771,44,9453,-1913,22884,3633,683815,39,22526,10503,55
1/28/2021,714388,3960,607556,2034,106832,1926,701542,5548791,6250333,20324,101,9409,-367,24797,4226,680182,84,22487,10448,70
1/27/2021,710428,2724,605522,2067,104906,657,699295,5530714,6230009,20597,154,9308,-1249,25164,3819,675956,65,22403,10378,62
1/26/2021,707704,3135,603455,2322,104249,813,696954,5512458,6209412,22519,192,9154,-1942,26413,4885,672137,77,22338,10316,82
1/25/2021,704569,1820,601133,1220,103436,600,694357,5492536,6186893,11552,111,8962,-3530,28355,5239,667252,57,22261,10234,76
1/24/2021,702749,1599,599913,1310,102836,289,692996,5482345,6175341,13148,40,8851,-1666,31885,3225,662013,42,22204,10158,84
1/23/2021,701150,4488,598603,3173,102547,1315,691478,5470715,6162193,37272,42,8811,1091,33551,3355,658788,92,22162,10074,73
1/22/2021,696662,2635,595430,1969,101232,666,687650,5437271,6124921,21148,93,8769,-2527,32460,5069,655433,53,22070,10001,74
1/21/2021,694027,4705,593461,3511,100566,1194,685348,5418425,6103773,32324,128,8676,-1969,34987,6546,650364,90,22017,9927,107
1/20/2021,689322,3111,589950,2101,99372,1010,681268,5390181,6071449,19980,86,8548,-2788,36956,5813,643818,63,21927,9820,86
1/19/2021,686211,4771,587849,2785,98362,1986,678834,5372635,6051469,21946,40,8462,-3183,39744,7914,638005,115,21864,9734,99
1/18/2021,681440,1615,585064,1067,96376,548,675692,5353831,6029523,8273,39,8422,-7221,42927,8797,630091,44,21749,9635,80
1/17/2021,679825,2566,583997,1877,95828,689,674530,5346720,6021250,15903,36,8383,-1899,50148,4429,621294,54,21705,9555,90
1/16/2021,677259,6919,582120,5342,95139,1577,672334,5333013,6005347,45694,44,8347,1293,52047,5582,616865,134,21651,9465,90
1/15/2021,670340,2758,576778,1817,93562,941,665960,5293693,5959653,14742,79,8303,-677,50754,3356,611283,66,21517,9375,90
1/14/2021,667582,6158,574961,4808,92621,1350,663937,5280974,5944911,36456,84,8224,-285,51431,6359,607927,106,21451,9285,107
1/13/2021,661424,4114,570153,2878,91271,1236,658467,5249988,5908455,21484,137,8140,-4054,51716,8031,601568,71,21345,9178,77
1/12/2021,657310,4743,567275,3014,90035,1729,655347,5231624,5886971,20974,146,8003,-6014,55770,10611,593537,78,21274,9101,98
1/11/2021,652567,3783,564261,2680,88306,1103,652045,5213952,5865997,14824,80,7857,-6349,61784,10052,582926,80,21196,9003,102
1/10/2021,648784,5377,561581,3696,87203,1681,649098,5202075,5851173,29758,81,7777,1028,68133,4268,572874,87,21116,8901,108
1/9/2021,643407,7216,557885,5750,85522,1466,644610,5176805,5821415,38846,86,7696,2006,67105,5124,568606,96,21029,8793,89
1/8/2021,636191,6052,552135,4577,84056,1475,638082,5144487,5782569,33512,126,7610,4246,65099,1680,563482,103,20933,8704,119
1/7/2021,630139,7339,547558,6306,82581,1033,632163,5116894,5749057,34176,111,7484,3148,60853,4080,561802,111,20830,8585,91
1/6/2021,622800,7356,541252,5168,81548,2188,625658,5089223,5714881,29292,114,7373,433,57705,6809,557722,138,20719,8494,115
1/5/2021,615444,8398,536084,5147,79360,3251,619996,5065593,5685589,25774,99,7259,-779,57272,9078,550913,139,20581,8379,115
1/4/2021,607046,4046,530937,3000,76109,1046,614653,5045162,5659815,10787,143,7160,-4627,58051,8530,541835,70,20442,8264,107
1/3/2021,603000,3511,527937,2373,75063,1138,611715,5037313,5649028,12684,55,7017,-259,62678,3715,533305,60,20372,8157,103
1/2/2021,599489,7192,525564,5729,73925,1463,609206,5027138,5636344,29338,15,6962,3105,62937,4072,529590,109,20312,8054,86
1/1/2021,592297,6672,519835,5223,72462,1449,602916,5004090,5607006,28505,48,6947,-407,59832,7031,525518,89,20203,7968,98
12/31/2020,585625,9170,514612,7245,71013,1925,597130,4981371,5578501,35344,97,6899,1917,60239,7156,518487,90,20114,7870,99
12/30/2020,576455,6692,507367,4535,69088,2157,589094,4954063,5543157,22087,100,6802,-720,58322,7312,511331,96,20024,7771,98
12/29/2020,569763,8067,502832,4955,66931,3112,584159,4936911,5521070,23780,122,6702,61,59042,7884,504019,134,19928,7673,98
12/28/2020,561696,3544,497877,2632,63819,912,578699,4918591,5497290,10045,76,6580,-6588,58981,10056,496135,97,19794,7575,89
12/27/2020,558152,3377,495245,2295,62907,1082,575887,4911358,5487245,12296,69,6504,-447,65569,3755,486079,86,19697,7486,87
12/26/2020,554775,4884,492950,3548,61825,1336,573289,4901660,5474949,22328,7,6435,836,66016,4041,482324,106,19611,7399,91
12/25/2020,549891,6621,489402,5433,60489,1188,569288,4883333,5452621,33666,5,6428,-573,65180,7189,478283,82,19505,7308,80
12/24/2020,543270,6641,483969,5029,59301,1612,563178,4855777,5418955,32546,51,6423,-523,65753,7113,471094,67,19423,7228,107
12/23/2020,536629,6084,478940,3975,57689,2109,557437,4828972,5386409,25878,111,6372,-1333,66276,7306,463981,99,19356,7121,98
12/22/2020,530545,6894,474965,4704,55580,2190,553017,4807514,5360531,28844,133,6261,-822,67609,7583,456675,144,19257,7023,108
12/21/2020,523651,5813,470261,4375,53390,1438,547766,4783921,5331687,26504,65,6128,-3927,68431,9675,449092,95,19113,6915,103
12/20/2020,517838,9976,465886,8333,51952,1643,542856,4762327,5305183,60917,54,6063,6409,72358,3513,439417,130,19018,6812,101
12/19/2020,507862,7059,457553,6026,50309,1033,533311,4710955,5244266,40083,57,6009,3184,65949,3818,435904,91,18888,6711,93
12/18/2020,500803,8253,451527,6980,49276,1273,526405,4677778,5204183,41254,115,5952,1860,62765,6278,432086,140,18797,6618,96
12/17/2020,492550,10137,444547,8048,48003,2089,518722,4644207,5162929,45090,177,5837,3135,60905,6825,425808,170,18657,6522,91
12/16/2020,482413,9303,436499,6481,45914,2822,509787,4608052,5117839,36037,53,5660,2254,57770,6996,418983,199,18487,6431,84
12/15/2020,473110,11787,430018,10299,43092,1488,502627,4579175,5081802,65212,74,5607,4579,55516,7134,411987,229,18288,6347,65
12/14/2020,461323,7902,419719,6842,41604,1060,490933,4525657,5016590,41734,79,5533,-2570,50937,10393,404853,156,18059,6282,75
12/13/2020,453421,11191,412877,9819,40544,1372,483327,4491529,4974856,69085,62,5454,7724,53507,3405,394460,170,17903,6207,86
12/12/2020,442230,8892,403058,7280,39172,1612,472179,4433592,4905771,47553,73,5392,5001,45783,3818,391055,175,17733,6121,79
12/11/2020,433338,6021,395778,5094,37560,927,463897,4394321,4858218,32001,87,5319,1708,40782,4226,387237,158,17558,6042,68
12/10/2020,427317,8853,390684,7744,36633,1109,458331,4367886,4826217,52214,69,5232,7528,39074,1256,383011,166,17400,5974,75
12/9/2020,418464,5784,382940,5115,35524,669,449616,4324387,4774003,27053,62,5163,145,31546,5577,381755,135,17234,5899,62
12/8/2020,412680,8059,377825,6999,34855,1060,444041,4302909,4746950,45352,100,5101,2342,31401,5617,376178,154,17099,5837,79
12/7/2020,404621,7108,370826,6122,33795,986,436275,4265323,4701598,35836,66,5001,-713,29059,7755,370561,128,16945,5758,72
12/6/2020,397513,4034,364704,3398,32809,636,429550,4236212,4665762,19685,38,4935,1151,29772,2845,362806,62,16817,5686,86
12/5/2020,393479,3054,361306,2508,32173,546,425843,4220234,4646077,15757,29,4897,17,28621,3008,359961,67,16755,5600,78
12/4/2020,390425,5352,358798,4283,31627,1069,423151,4207169,4630320,26784,95,4868,-310,28604,5567,356953,124,16688,5522,83
12/3/2020,385073,4788,354515,3989,30558,799,418335,4185201,4603536,25423,93,4773,575,28914,4120,351386,99,16564,5439,72
12/2/2020,380285,2494,350526,2104,29759,390,413960,4164153,4578113,11735,50,4680,-2541,28339,4985,347266,74,16465,5367,67
12/1/2020,377791,6643,348422,5656,29369,987,411794,4154584,4566378,36388,36,4630,1032,30880,5575,342281,143,16391,5300,68
11/30/2020,371148,5936,342766,5373,28382,563,405569,4124421,4529990,40831,48,4594,-1189,29848,7077,336706,104,16248,5232,80
11/29/2020,365212,5469,337393,5046,27819,423,399564,4089595,4489159,37789,13,4546,2457,31037,2999,329629,90,16144,5152,57
11/28/2020,359743,4655,332347,4043,27396,612,393848,4057522,4451370,32017,15,4533,1571,28580,3069,326630,91,16054,5095,62
11/27/2020,355088,5365,328304,4778,26784,587,389287,4030066,4419353,32540,7,4518,376,27009,4982,323561,88,15963,5033,80
11/26/2020,349723,5241,323526,4889,26197,352,383772,4003041,4386813,52148,53,4511,-455,26633,5643,318579,75,15875,4953,47
11/25/2020,344482,2190,318637,1588,25845,602,377895,3956770,4334665,11966,92,4458,-2363,27088,4461,312936,98,15800,4906,65
11/24/2020,342292,2048,317049,1521,25243,527,376439,3946260,4322699,10727,73,4366,-3422,29451,5397,308475,98,15702,4841,66
11/23/2020,340244,2205,315528,1849,24716,356,374930,3937042,4311972,11341,35,4293,-4646,32873,6816,303078,79,15604,4775,68
11/22/2020,338039,5511,313679,5017,24360,494,373051,3927580,4300631,43967,55,4258,2874,37519,2582,296262,131,15525,4707,59
11/21/2020,332528,3410,308662,2901,23866,509,367390,3889274,4256664,25739,9,4203,801,34645,2600,293680,103,15394,4648,74
11/20/2020,329118,4015,305761,3511,23357,504,364249,3866676,4230925,24632,74,4194,-43,33844,3984,291080,108,15291,4574,67
11/19/2020,325103,2986,302250,2284,22853,702,360388,3845905,4206293,16546,80,4120,-1341,33887,4247,287096,111,15183,4507,57
11/18/2020,322117,4013,299966,3046,22151,967,357973,3831774,4189747,23885,53,4040,-95,35228,4055,282849,136,15072,4450,43
11/17/2020,318104,3502,296920,3183,21184,319,354552,3811310,4165862,21281,72,3987,-104,35323,3534,278794,94,14936,4407,68
11/16/2020,314602,4632,293737,4226,20865,406,351000,3793581,4144581,35558,30,3915,-48,35427,4650,275260,133,14842,4339,52
11/15/2020,309970,6425,289511,5818,20459,607,346278,3762745,4109023,55161,16,3885,4490,35475,1919,270610,166,14709,4287,48
11/14/2020,303545,4857,283693,4432,19852,425,339689,3714173,4053862,38310,25,3869,3033,30985,1799,268691,139,14543,4239,61
11/13/2020,298688,4344,279261,3737,19427,607,334665,3680887,4015552,27466,64,3844,1525,27952,2755,266892,114,14404,4178,43
11/12/2020,294344,3135,275524,2574,18820,561,330643,3657443,3988086,19161,27,3780,406,26427,2702,264137,99,14290,4135,36
11/11/2020,291209,3900,272950,3287,18259,613,327912,3641013,3968925,28259,89,3753,980,26021,2831,261435,111,14191,4099,49
11/10/2020,287309,3006,269663,2479,17646,527,324097,3616569,3940666,25241,62,3664,90,25041,2854,258604,110,14080,4050,49
11/9/2020,284303,2373,267184,2051,17119,322,321366,3594059,3915425,19658,15,3602,-883,24951,3241,255750,72,13970,4001,42
11/8/2020,281930,5353,265133,4821,16797,532,319048,3576719,3895767,55328,5,3587,3542,25834,1806,252509,158,13898,3959,40
11/7/2020,276577,4155,260312,3833,16265,322,313504,3526935,3840439,43172,49,3582,2241,22292,1865,250703,129,13740,3919,33
11/6/2020,272422,3571,256479,3012,15943,559,309016,3488251,3797267,28747,32,3533,932,20051,2607,248838,92,13611,3886,47
11/5/2020,268851,1401,253467,1110,15384,291,305651,3462869,3768520,10722,31,3501,-1314,19119,2684,246231,74,13519,3839,40
11/4/2020,267450,2634,252357,2339,15093,295,304416,3453382,3757798,23433,24,3470,-159,20433,2769,243547,103,13445,3799,50
11/3/2020,264816,2999,250018,2696,14798,303,301802,3432563,3734365,24850,75,3446,232,20592,2692,240778,79,13342,3749,45
11/2/2020,261817,1888,247322,1764,14495,124,298771,3410744,3709515,16835,26,3371,-1350,20360,3212,238086,73,13263,3704,38
11/1/2020,259929,2469,245558,2105,14371,364,296809,3395871,3692680,33700,0,3345,765,21710,1704,234874,101,13190,3666,32
10/31/2020,257460,148,243453,136,14007,12,294359,3364621,3658980,811,12,3345,-1535,20945,1671,233170,2,13089,3634,29
10/30/2020,257312,2381,243317,2166,13995,215,294218,3363951,3658169,22520,78,3333,82,22480,2221,231499,76,13087,3605,40
10/29/2020,254931,2359,241151,2032,13780,327,291839,3343810,3635649,25222,22,3255,29,22398,2308,229278,93,13011,3565,38
10/28/2020,252572,2661,239119,2378,13453,283,289576,3320851,3610427,23469,34,3233,136,22369,2491,226970,94,12918,3527,37
10/27/2020,249911,2432,236741,2030,13170,402,286935,3300023,3586958,22626,44,3199,-14,22233,2402,224479,130,12824,3490,46
10/26/2020,247479,1490,234711,1305,12768,185,284630,3279702,3564332,11304,32,3155,-1379,22247,2837,222077,59,12694,3444,31
10/25/2020,245989,3073,233406,2885,12583,188,283183,3269845,3553028,35767,31,3123,1575,23626,1467,219240,124,12635,3413,42
10/24/2020,242916,3577,230521,3287,12395,290,279709,3237552,3517261,40055,24,3092,1893,22051,1660,217773,127,12511,3371,45
10/23/2020,239339,2639,227234,2392,12105,247,275904,3201302,3477206,29753,65,3068,493,20158,2081,216113,115,12384,3326,33
10/22/2020,236700,3166,224842,2816,11858,350,273246,3174207,3447453,35915,41,3003,1122,19665,2003,214032,125,12269,3293,28
10/21/2020,233534,1724,222026,1479,11508,245,270054,3141484,3411538,15151,18,2962,-530,18543,2236,212029,65,12144,3265,38
10/20/2020,231810,1947,220547,1666,11263,281,268364,3128023,3396387,17087,30,2944,-88,19073,2005,209793,86,12079,3227,37
10/19/2020,229863,2173,218881,1979,10982,194,266505,3112795,3379300,21960,13,2914,-189,19161,2349,207788,117,11993,3190,33
10/18/2020,227690,2619,216902,2448,10788,171,264274,3093066,3357340,39540,6,2901,1308,19350,1305,205439,105,11876,3157,21
10/17/2020,225071,2662,214454,2460,10617,202,261369,3056431,3317800,36712,32,2895,1284,18042,1346,204134,95,11771,3136,27
10/16/2020,222409,1705,211994,1516,10415,189,258428,3022660,3281088,16312,7,2863,-139,16758,1837,202788,63,11676,3109,29
10/15/2020,220704,1411,210478,1213,10226,198,256851,3007925,3264776,16188,36,2856,-324,16897,1699,200951,69,11613,3080,41
10/14/2020,219293,2298,209265,2098,10028,200,255498,2993090,3248588,22260,31,2820,557,17221,1710,199252,88,11544,3039,37
10/13/2020,216995,1537,207167,1266,9828,271,253278,2973050,3226328,16045,23,2789,-13,16664,1527,197542,74,11456,3002,36
10/12/2020,215458,1221,205901,1044,9557,177,251853,2958430,3210283,15533,7,2766,-829,16677,2043,196015,59,11382,2966,36
10/11/2020,214237,2931,204857,2737,9380,194,250648,2944102,3194750,42643,9,2759,1841,17506,1081,193972,124,11323,2930,28
10/10/2020,211306,1873,202120,1767,9186,106,247497,2904610,3152107,29601,26,2750,829,15665,1018,192891,74,11199,2902,29
10/9/2020,209433,1406,200353,1237,9080,169,245483,2877023,3122506,25936,27,2724,47,14836,1332,191873,54,11125,2873,26
10/8/2020,208027,1991,199116,1803,8911,188,244096,2852474,3096570,25699,63,2697,535,14789,1393,190541,81,11071,2847,26
10/7/2020,206036,1833,197313,1568,8723,265,242166,2828705,3070871,23359,21,2634,354,14254,1458,189148,96,10990,2821,28
10/6/2020,204203,1992,195745,1699,8458,293,240425,2807087,3047512,25174,24,2613,442,13900,1526,187690,118,10894,2793,27
10/5/2020,202211,2202,194046,1991,8165,211,238461,2783877,3022338,35591,20,2589,363,13458,1819,186164,118,10776,2766,25
10/4/2020,200009,1802,192055,1654,7954,148,235978,2750769,2986747,38287,17,2569,869,13095,916,184345,85,10658,2741,29
10/3/2020,198207,1348,190401,1237,7806,111,233844,2714616,2948460,29088,45,2552,336,12226,967,183429,55,10573,2712,18
10/2/2020,196859,1197,189164,1061,7695,136,232225,2687147,2919372,15596,14,2507,-293,11890,1476,182462,60,10518,2694,22
10/1/2020,195662,1142,188103,1001,7559,141,230925,2672851,2903776,18441,47,2493,-308,12183,1403,180986,72,10458,2672,21
9/30/2020,194520,1425,187102,1252,7418,173,229727,2655608,2885335,13669,34,2446,-78,12491,1469,179583,46,10386,2651,26
9/29/2020,193095,1186,185850,972,7245,214,228249,2643417,2871666,20808,31,2412,-288,12569,1443,178114,80,10340,2625,14
9/28/2020,191909,671,184878,544,7031,127,226944,2623914,2850858,8494,12,2381,-1230,12857,1889,176671,37,10260,2611,26
9/27/2020,191238,1358,184334,1271,6904,87,226237,2616127,2842364,29427,3,2369,429,14087,926,174782,65,10223,2585,24
9/26/2020,189880,2114,183063,1973,6817,141,224699,2588238,2812937,44148,22,2366,1029,13658,1063,173856,75,10158,2561,23
9/25/2020,187766,1336,181090,1237,6676,99,222246,2546543,2768789,26053,42,2344,-116,12629,1410,172793,59,10083,2538,23
9/24/2020,186430,1395,179853,1227,6577,168,220727,2522009,2742736,27000,35,2302,-98,12745,1458,171383,67,10024,2515,20
9/23/2020,185035,914,178626,798,6409,116,219222,2496514,2715736,9557,14,2267,-618,12843,1518,169925,32,9957,2495,28
9/22/2020,184121,1635,177828,1417,6293,218,218270,2487909,2706179,25555,28,2253,-184,13461,1791,168407,73,9925,2467,20
9/21/2020,182486,664,176411,519,6075,145,216383,2464241,2680624,7053,15,2225,-396,13645,1045,166616,46,9852,2447,20
9/20/2020,181822,1022,175892,909,5930,113,215674,2457897,2673571,20390,2,2210,140,14041,880,165571,48,9806,2427,26
9/19/2020,180800,2125,174983,2024,5817,101,214468,2438713,2653181,48385,20,2208,1203,13901,902,164691,108,9758,2401,18
9/18/2020,178675,1499,172959,1328,5716,171,211982,2392814,2604796,30010,32,2188,-307,12698,1774,163789,61,9650,2383,28
9/17/2020,177176,1814,171631,1676,5545,138,210310,2364476,2574786,27716,13,2156,419,13005,1382,162015,64,9589,2355,26
9/16/2020,175362,1054,169955,924,5407,130,208273,2338797,2547070,16886,24,2143,-374,12586,1404,160633,52,9525,2329,21
9/15/2020,174308,1890,169031,1670,5277,220,207069,2323115,2530184,34233,30,2119,295,12960,1565,159229,92,9473,2308,17
9/14/2020,172418,1597,167361,1433,5057,164,204787,2291164,2495951,22930,19,2089,-66,12665,1644,157664,94,9381,2291,27
9/13/2020,170821,1391,165928,1307,4893,84,203000,2270021,2473021,22627,14,2070,384,12731,993,156020,53,9287,2264,14
9/12/2020,169430,1322,164621,1245,4809,77,201330,2249064,2450394,26754,39,2056,459,12347,824,155027,48,9234,2250,35
9/11/2020,168108,1002,163376,892,4732,110,199671,2223969,2423640,15176,37,2017,-1369,11888,2334,154203,51,9186,2215,28
9/10/2020,167106,1994,162484,1817,4622,177,198557,2209907,2408464,31351,57,1980,513,13257,1424,151869,84,9135,2187,23
9/9/2020,165112,1138,160667,1033,4445,105,196325,2180788,2377113,17902,35,1923,-348,12744,1451,150445,64,9051,2164,22
9/8/2020,163974,815,159634,707,4340,108,194994,2164217,2359211,13216,27,1888,-745,13092,1533,148994,50,8987,2142,25
9/7/2020,163159,779,158927,732,4232,47,194134,2151861,2345995,7879,4,1861,-952,13837,1727,147461,40,8937,2117,17
9/6/2020,162380,822,158195,771,4185,51,193007,2145109,2338116,12143,3,1857,-66,14789,885,145734,40,8897,2100,35
9/5/2020,161558,2551,157424,2482,4134,69,192095,2133878,2325973,35188,25,1854,1522,14855,1004,144849,58,8857,2065,21
9/4/2020,159007,1111,154942,1032,4065,79,189176,2101609,2290785,13310,22,1829,-161,13333,1250,143845,51,8799,2044,21
9/3/2020,157896,1651,153910,1510,3986,141,187987,2089488,2277475,28565,18,1807,23,13494,1610,142595,61,8748,2023,22
9/2/2020,156245,1181,152400,1075,3845,106,186093,2062817,2248910,16329,16,1789,-320,13471,1485,140985,57,8687,2001,23
9/1/2020,155064,1682,151325,1519,3739,163,184847,2047734,2232581,23063,27,1773,116,13791,1539,139500,72,8630,1978,22
8/31/2020,153382,1237,149806,1168,3576,69,182866,2026652,2209518,12818,7,1746,-349,13675,1579,137961,41,8558,1956,24
8/30/2020,152145,1460,148638,1427,3507,33,181466,2015234,2196700,8545,22,1739,526,14024,912,136382,40,8517,1932,15
8/29/2020,150685,1525,147211,1418,3474,107,179861,2008294,2188155,25424,24,1717,361,13498,1140,135470,55,8477,1917,25
8/28/2020,149160,1123,145793,1069,3367,54,178082,1984649,2162731,12750,28,1693,-470,13137,1565,134330,50,8422,1892,23
8/27/2020,148037,2326,144724,2202,3313,124,176796,1973185,2149981,37062,25,1665,906,13607,1395,132765,70,8372,1869,25
8/26/2020,145711,1312,142522,1196,3189,116,174075,1938844,2112919,18050,20,1640,-391,12701,1683,131370,56,8302,1844,30
8/25/2020,144399,1697,141326,1580,3073,117,172547,1922322,2094869,30518,40,1620,115,13092,1542,129687,69,8246,1814,24
8/24/2020,142702,644,139746,531,2956,113,170548,1893803,2064351,7024,21,1580,-1391,12977,2014,128145,41,8177,1790,34
8/23/2020,142058,810,139215,749,2843,61,169851,1887476,2057327,14502,4,1559,-204,14368,1010,126131,42,8136,1756,24
8/22/2020,141248,2424,138466,2361,2782,63,168929,1873896,2042825,52098,14,1555,1234,14572,1176,125121,76,8094,1732,17
8/21/2020,138824,525,136105,482,2719,43,165994,1824733,1990727,10360,61,1541,-1224,13338,1688,123945,32,8018,1715,20
8/20/2020,138299,2429,135623,2255,2676,174,165431,1814936,1980367,42755,36,1480,748,14562,1645,122257,86,7986,1695,20
8/19/2020,135870,1334,133368,1268,2502,66,162648,1774964,1937612,20258,26,1444,-536,13814,1844,120612,56,7900,1675,22
8/18/2020,134536,1759,132100,1644,2436,115,161079,1756275,1917354,37948,39,1418,-212,14350,1932,118768,67,7844,1653,16
8/17/2020,132777,842,130456,708,2321,134,158626,1720780,1879406,9074,21,1379,-1293,14562,2114,116836,58,7777,1637,19
8/16/2020,131935,1397,129748,1371,2187,26,157751,1712581,1870332,20072,21,1358,301,15855,1075,114722,44,7719,1618,30
8/15/2020,130538,1920,128377,1835,2161,85,155946,1694314,1850260,27266,19,1337,577,15554,1324,113647,64,7675,1588,28
8/14/2020,128618,1369,126542,1288,2076,81,153432,1669562,1822994,15123,13,1318,-350,14977,1706,112323,45,7611,1560,22
8/13/2020,127249,2501,125254,2403,1995,98,151805,1656066,1807871,36484,24,1305,573,15327,1904,110617,122,7566,1538,23
8/12/2020,124748,1243,122851,1204,1897,39,148503,1622884,1771387,13804,18,1281,-761,14754,1986,108713,59,7444,1515,25
8/11/2020,123505,1798,121647,1684,1858,114,147096,1610487,1757583,24157,38,1263,-163,15515,1923,106727,82,7385,1490,26
8/10/2020,121707,894,119963,842,1744,52,144947,1588479,1733426,8439,10,1225,-1466,15678,2350,104804,74,7303,1464,29
8/9/2020,120813,1567,119121,1539,1692,28,143965,1581022,1724987,17475,8,1215,455,17144,1104,102454,55,7229,1435,14
8/8/2020,119246,2096,117582,2033,1664,63,142063,1565449,1707512,33953,9,1207,930,16689,1157,101350,71,7174,1421,21
8/7/2020,117150,1775,115549,1722,1601,53,139440,1534119,1673559,18425,20,1198,109,15759,1646,100193,109,7103,1400,25
8/6/2020,115375,2724,113827,2613,1548,111,137303,1517831,1655134,32188,42,1178,1002,15650,1680,98547,125,6994,1375,25
8/5/2020,112651,1339,111214,1272,1437,67,133997,1488949,1622946,14095,27,1136,-649,14648,1961,96867,62,6869,1350,17
8/4/2020,111312,1735,109942,1652,1370,83,132467,1476384,1608851,21050,25,1109,-371,15297,2081,94906,112,6807,1333,20
8/3/2020,109577,1788,108290,1756,1287,32,130386,1457415,1587801,16815,19,1084,-685,15668,2454,92825,70,6695,1313,25
8/2/2020,107789,1071,106534,1048,1255,23,128300,1442686,1570986,13184,6,1065,-82,16353,1147,90371,62,6625,1288,37
8/1/2020,106718,2152,105486,2123,1232,29,127014,1430788,1557802,31928,7,1059,809,16435,1336,89224,84,6563,1251,23
7/31/2020,104566,1743,103363,1695,1203,48,124242,1401632,1525874,18456,27,1052,-101,15626,1817,87888,84,6479,1228,27
7/30/2020,102823,3554,101668,3511,1155,43,122279,1385139,1507418,42888,13,1025,1632,15727,1909,86071,149,6395,1201,29
7/29/2020,99269,1173,98157,1145,1112,28,117947,1346583,1464530,9570,21,1012,-1233,14095,2385,84162,80,6246,1172,32
7/28/2020,98096,2487,97012,2443,1084,44,116647,1338313,1454960,28669,21,991,131,15328,2335,81777,155,6166,1140,21
7/27/2020,95609,1897,94569,1858,1040,39,113561,1312730,1426291,17976,11,970,-813,15197,2699,79442,120,6011,1119,17
7/26/2020,93712,2303,92711,2251,1001,52,111300,1297015,1408315,26773,3,959,971,16010,1329,76743,99,5891,1102,21
7/25/2020,91409,3074,90460,3034,949,40,108469,1273073,1381542,38614,26,956,1591,15039,1457,75414,141,5792,1081,20
7/24/2020,88335,1839,87426,1795,909,44,104660,1238268,1342928,22638,13,930,-361,13448,2187,73957,116,5651,1061,28
7/23/2020,86496,2513,85631,2465,865,48,102297,1217993,1320290,37791,37,917,393,13809,2083,71770,141,5535,1033,27
7/22/2020,83983,1982,83166,1953,817,29,99114,1183385,1282499,17280,17,880,-464,13416,2429,69687,116,5394,1006,30
7/21/2020,82001,3141,81213,3114,788,27,96780,1168439,1265219,39699,24,863,588,13880,2529,67258,175,5278,976,17
7/20/2020,78860,1193,78099,1156,761,37,92883,1132637,1225520,9762,4,839,-1592,13292,2781,64729,58,5103,959,20
7/19/2020,77667,1569,76943,1546,724,23,91550,1124208,1215758,18801,5,835,-25,14884,1589,61948,70,5045,939,16
7/18/2020,76098,2110,75397,2089,701,21,89598,1107359,1196957,26372,23,830,806,14909,1281,60359,98,4975,923,17
7/17/2020,73988,2120,73308,2075,680,45,86915,1083670,1170585,22189,19,807,521,14103,1580,59078,106,4877,906,16
7/16/2020,71868,2946,71233,2904,635,42,84355,1064041,1148396,39514,13,788,1095,13582,1838,57498,137,4771,890,18
7/15/2020,68922,1922,68329,1885,593,37,80545,1028337,1108882,19718,16,775,-115,12487,2021,55660,109,4634,872,17
7/14/2020,67000,2104,66444,2062,556,42,78351,1010813,1089164,23644,18,759,206,12602,1880,53639,120,4525,855,11
7/13/2020,64896,1816,64382,1786,514,30,75843,989677,1065520,17508,8,741,-89,12396,1897,51759,78,4405,844,19
7/12/2020,63080,2315,62596,2289,484,26,73824,974188,1048012,28203,3,733,1217,12485,1095,49862,118,4327,825,17
7/11/2020,60765,1174,60307,1160,458,14,70937,948872,1019809,15261,15,730,14,11268,1145,48767,55,4209,808,13
7/10/2020,59591,1965,59147,1937,444,28,69436,935112,1004548,18448,13,715,568,11254,1384,47622,99,4154,795,17
7/9/2020,57626,1800,57210,1775,416,25,67216,918884,986100,24770,25,702,376,10686,1399,46238,107,4055,778,17
7/8/2020,55826,1640,55435,1615,391,25,65158,896172,961330,19567,20,677,58,10310,1562,44839,88,3948,761,12
7/7/2020,54186,2142,53820,2131,366,11,63258,878505,941763,27214,12,657,716,10252,1414,43277,127,3860,749,18
7/6/2020,52044,882,51689,869,355,13,60604,853945,914549,8281,7,645,-621,9536,1496,41863,67,3733,731,11
7/5/2020,51162,1337,50820,1335,342,2,59679,846589,906268,15208,9,638,569,10157,759,40367,54,3666,720,19
7/4/2020,49825,1452,49485,1450,340,2,58079,832981,891060,21575,4,629,619,9588,829,39608,63,3612,701,16
7/3/2020,48373,1340,48035,1331,338,9,56245,813240,869485,16443,13,625,308,8969,1019,38779,66,3549,685,12
7/2/2020,47033,1914,46704,1906,329,8,54754,798288,853042,25851,11,612,982,8661,921,37760,101,3483,673,9
7/1/2020,45119,1418,44798,1413,321,5,52486,774705,827191,18053,5,601,468,7679,945,36839,73,3382,664,14
6/30/2020,43701,1644,43385,1632,316,12,50783,758355,809138,25210,12,596,770,7211,862,35894,76,3309,650,12
6/29/2020,42057,1774,41753,1767,304,7,48627,735301,783928,23518,0,584,795,6441,979,35032,106,3233,638,8
6/28/2020,40283,654,39986,652,297,2,46598,713812,760410,9911,0,584,222,5646,432,34053,20,3127,630,8
6/27/2020,39629,263,39334,257,295,6,45820,704679,750499,2063,7,584,-332,5424,588,33621,25,3107,622,8
6/26/2020,39366,973,39077,950,289,23,45549,702887,748436,10013,10,577,291,5756,672,33033,67,3082,614,14
6/25/2020,38393,1066,38127,1057,266,9,44530,693893,738423,14034,11,567,430,5465,625,32361,57,3015,600,9
6/24/2020,37327,840,37070,832,257,8,43313,681076,724389,8622,14,556,122,5035,704,31736,53,2958,591,7
6/23/2020,36487,1013,36238,1006,249,7,42329,673438,715767,11331,11,542,364,4913,638,31032,65,2905,584,5
6/22/2020,35474,624,35232,612,242,12,41168,663268,704436,10574,5,531,-185,4549,804,30394,29,2840,579,6
6/21/2020,34850,590,34620,589,230,1,40511,653351,693862,13657,2,526,198,4734,390,29590,25,2811,573,10
6/20/2020,34260,404,34031,403,229,1,39718,640487,680205,9129,0,524,-66,4536,470,29200,29,2786,563,6
6/19/2020,33856,737,33628,733,228,4,39188,631888,671076,10194,15,524,211,4602,511,28730,48,2757,557,9
6/18/2020,33119,1094,32895,1092,224,2,38309,622573,660882,15398,12,509,498,4391,584,28219,81,2709,548,5
6/17/2020,32025,405,31803,401,222,4,37037,608447,645484,5622,4,497,-219,3893,620,27635,27,2628,543,10
6/16/2020,31620,612,31402,609,218,3,36611,603251,639862,7803,10,493,139,4112,463,27015,42,2601,533,6
6/15/2020,31008,707,30793,694,215,13,35917,596142,632059,10574,8,483,19,3973,680,26552,44,2559,527,15
6/14/2020,30301,603,30099,599,202,4,35098,586387,621485,13819,3,475,254,3954,346,25872,28,2515,512,9
6/13/2020,29698,538,29500,533,198,5,34354,573312,607666,10590,4,472,156,3700,378,25526,23,2487,503,7
6/12/2020,29160,544,28967,542,193,2,33631,563445,597076,9460,27,468,-42,3544,559,25148,36,2464,496,4
6/11/2020,28616,612,28425,609,191,3,33016,554600,587616,9730,5,441,-162,3586,769,24589,29,2428,492,5
6/10/2020,28004,427,27816,422,188,5,32310,545576,577886,8415,1,436,-176,3748,602,23820,47,2399,487,1
6/9/2020,27577,585,27394,580,183,5,31919,537552,569471,9392,14,435,-45,3924,616,23218,40,2352,486,4
6/8/2020,26992,487,26814,483,178,4,31245,528834,560079,10056,3,421,98,3969,386,22602,27,2312,482,5
6/7/2020,26505,426,26331,423,174,3,30686,519337,550023,13835,1,418,158,3871,267,22216,27,2285,477,5
6/6/2020,26079,468,25908,465,171,3,30086,506102,536188,10921,9,417,186,3713,273,21949,24,2258,472,10
6/5/2020,25611,509,25443,500,168,9,29522,495745,525267,11807,7,408,5,3527,497,21676,23,2234,462,6
6/4/2020,25102,227,24943,224,159,3,28903,484557,513460,5570,13,401,-265,3522,479,21179,20,2211,456,3
6/3/2020,24875,353,24719,352,156,1,28686,479204,507890,7917,7,388,-156,3787,502,20700,39,2191,453,8
6/2/2020,24522,644,24367,641,155,3,28259,471714,499973,14361,14,381,193,3943,437,20198,32,2152,445,7
6/1/2020,23878,603,23726,599,152,4,27436,458176,485612,10580,3,367,-104,3750,704,19761,23,2120,438,6
5/31/2020,23275,607,23127,605,148,2,26669,448363,475032,15760,0,364,393,3854,214,19057,48,2097,432,5
5/30/2020,22668,456,22522,455,146,1,25970,433302,459272,9709,4,364,159,3461,293,18843,21,2049,427,10
5/29/2020,22212,230,22067,226,145,4,25399,424164,449563,7039,4,360,-169,3302,395,18550,17,2028,417,7
5/28/2020,21982,596,21841,595,141,1,25130,417394,442524,9193,3,356,220,3471,373,18155,35,2011,410,4
5/27/2020,21386,214,21246,208,140,6,24458,408873,433331,6753,10,353,-126,3251,330,17782,27,1976,406,7
5/26/2020,21172,354,21038,344,134,10,24260,402318,426578,6876,5,343,-31,3377,380,17452,21,1949,399,4
5/25/2020,20818,594,20694,593,124,1,23862,395840,419702,11386,2,338,245,3408,347,17072,31,1928,395,6
5/24/2020,20224,331,20101,331,123,0,23155,385161,408316,11943,7,336,122,3163,202,16725,17,1897,389,10
5/23/2020,19893,418,19770,413,123,5,22725,373648,396373,11174,14,329,238,3041,166,16523,23,1880,379,6
5/22/2020,19475,385,19357,381,118,4,22180,363019,385199,9003,2,315,86,2803,297,16357,31,1857,373,3
5/21/2020,19090,383,18976,382,114,1,21731,354465,376196,6641,4,313,-257,2717,636,16060,18,1826,370,8
5/20/2020,18707,259,18594,258,113,1,21343,348212,369555,8400,4,309,-313,2974,568,15424,18,1808,362,5
5/19/2020,18448,334,18336,333,112,1,21038,340117,361155,6811,4,305,-98,3287,428,14856,26,1790,357,2
5/18/2020,18114,341,18003,339,111,2,20636,333708,354344,8827,3,301,0,3385,338,14428,23,1764,355,4
5/17/2020,17773,471,17664,471,109,0,20212,325305,345517,14077,3,298,304,3385,164,14090,23,1741,351,7
5/16/2020,17302,260,17193,243,109,17,19631,311809,331440,11002,5,295,43,3081,212,13926,18,1718,344,6
5/15/2020,17042,193,16950,191,92,2,19275,301163,320438,8138,3,290,-193,3038,383,13714,11,1700,338,8
5/14/2020,16849,261,16759,260,90,1,19055,293245,312300,10152,14,287,-119,3231,366,13331,17,1689,330,15
5/13/2020,16588,320,16499,317,89,3,18700,283448,302148,10220,9,273,-495,3350,806,12965,29,1672,315,11
5/12/2020,16268,696,16182,696,86,0,18315,273613,291928,14783,13,264,-411,3845,1094,12159,24,1643,304,8
5/11/2020,15572,552,15486,549,86,3,17508,259637,277145,9970,8,251,178,4256,366,11065,19,1619,296,4
5/10/2020,15020,247,14937,244,83,3,16928,250247,267175,10212,1,243,65,4078,181,10699,12,1600,292,4
5/9/2020,14773,244,14693,242,80,2,16561,240402,256963,9807,1,242,9,4013,234,10518,15,1588,288,8
5/8/2020,14529,195,14451,194,78,1,16246,230910,247156,6575,4,241,-198,4004,389,10284,15,1573,280,6
5/7/2020,14334,392,14257,390,77,2,16001,224580,240581,10787,-2,237,81,4202,313,9895,27,1558,274,8
5/6/2020,13942,258,13867,258,75,0,15527,214267,229794,5945,13,239,-93,4121,338,9582,14,1531,266,3
5/5/2020,13684,189,13609,188,75,1,15205,208644,223849,7851,7,226,-141,4214,323,9244,27,1517,263,10
5/4/2020,13495,310,13421,306,74,4,14965,201033,215998,7076,9,219,-306,4355,607,8921,21,1490,253,6
5/3/2020,13185,370,13115,364,70,6,14599,194323,208922,9415,1,210,118,4661,251,8314,28,1469,247,9
5/2/2020,12815,238,12751,237,64,1,14150,185357,199507,7038,5,209,-99,4543,332,8063,18,1441,238,5
5/1/2020,12577,769,12514,764,63,5,13800,178669,192469,9536,5,204,469,4642,295,7731,20,1423,233,5
4/30/2020,11808,1002,11750,998,58,4,12997,169936,182933,5191,4,199,778,4173,220,7436,33,1403,228,5
4/29/2020,10806,568,10752,566,54,2,11954,165788,177742,10958,7,195,330,3395,231,7216,35,1370,223,5
4/28/2020,10238,274,10186,270,52,4,11297,155487,166784,6527,4,188,40,3065,230,6985,33,1335,218,6
4/27/2020,9964,297,9916,293,48,4,10993,149264,160257,5461,3,184,-14,3025,308,6755,38,1302,212,5
4/26/2020,9667,298,9623,297,44,1,10660,144136,154796,6697,3,181,139,3039,156,6447,18,1264,207,4
4/25/2020,9369,301,9326,296,43,5,10312,137787,148099,4558,10,178,131,2900,160,6291,24,1246,203,6
4/24/2020,9068,468,9030,459,38,9,9967,133574,143541,14207,-2,168,246,2769,224,6131,42,1222,197,5
4/23/2020,8600,452,8571,450,29,2,9427,119907,129334,5038,4,170,300,2523,148,5907,19,1180,192,10
4/22/2020,8148,499,8121,497,27,2,8947,115349,124296,9053,9,166,282,2223,208,5759,20,1161,182,3
4/21/2020,7649,288,7624,286,25,2,8391,106852,115243,6847,5,157,95,1941,188,5551,27,1141,179,5
4/20/2020,7361,250,7338,242,23,8,8061,100335,108396,6529,4,152,27,1846,219,5363,27,1114,174,4
4/19/2020,7111,277,7096,276,15,1,7796,94071,101867,5158,3,148,152,1819,122,5144,11,1087,170,3
4/18/2020,6834,173,6820,173,14,0,7474,89235,96709,5013,3,145,8,1667,162,5022,14,1076,167,2
4/17/2020,6661,320,6647,319,14,1,7239,84457,91696,3326,1,142,124,1659,195,4860,34,1062,165,3
4/16/2020,6341,290,6328,290,13,0,6872,81498,88370,4139,6,141,79,1535,205,4665,23,1028,162,6
4/15/2020,6051,263,6038,263,13,0,6522,77709,84231,3146,11,135,20,1456,232,4460,20,1005,156,6
4/14/2020,5788,182,5775,182,13,0,6214,74871,81085,1711,15,124,-49,1436,216,4228,29,985,150,10
4/13/2020,5606,216,5593,215,13,1,5995,73379,79374,4434,8,109,-10,1485,218,4012,39,956,140,8
4/12/2020,5390,225,5378,223,12,2,5727,69213,74940,5096,0,101,83,1495,142,3794,33,917,132,8
4/11/2020,5165,292,5155,292,10,0,5482,64362,69844,5010,3,101,27,1412,262,3652,43,884,124,7
4/10/2020,4873,195,4863,194,10,1,5112,59722,64834,2441,4,98,-29,1385,220,3390,24,841,117,2
4/9/2020,4678,279,4669,279,9,0,4918,57475,62393,3496,15,94,51,1414,213,3170,42,817,115,5
4/8/2020,4399,205,4390,205,9,0,4594,54303,58897,2813,7,79,-45,1363,243,2957,31,775,110,16
4/7/2020,4194,306,4185,306,9,0,4355,51729,56084,4851,7,72,59,1408,240,2714,43,744,94,7
4/6/2020,3888,228,3879,228,9,0,4032,47201,51233,3717,21,65,-71,1349,278,2474,47,701,87,7
4/5/2020,3660,312,3651,311,9,1,3775,43741,47516,3819,1,44,126,1420,185,2196,48,654,80,10
4/4/2020,3348,201,3340,201,8,0,3411,40286,43697,3475,6,43,-14,1294,209,2011,26,606,70,4
4/3/2020,3147,252,3139,251,8,1,3213,37009,40222,2640,5,37,3,1308,244,1802,43,580,66,16
4/2/2020,2895,270,2888,270,7,0,2941,34641,37582,3872,8,32,37,1305,225,1558,58,537,50,6
4/1/2020,2625,357,2618,357,7,0,2654,31056,33710,3767,1,24,134,1268,222,1333,59,479,44,8
3/31/2020,2268,287,2261,287,7,0,2267,27676,29943,2963,10,23,70,1134,207,1111,47,420,36,8
3/30/2020,1981,439,1974,439,7,0,1962,25018,26980,5045,6,13,227,1064,206,904,84,373,28,6
3/29/2020,1542,102,1535,102,7,0,1515,20420,21935,837,1,7,-47,837,148,698,36,289,22,6
3/28/2020,1440,196,1433,191,7,5,1414,19684,21098,2378,0,6,89,884,107,550,39,253,16,4
3/27/2020,1244,207,1242,207,2,0,1219,17501,18720,2803,3,6,96,795,108,443,42,214,12,2
3/26/2020,1037,168,1035,167,2,1,1007,14910,15917,2969,0,3,85,699,83,335,30,172,10,4
3/25/2020,869,157,868,157,1,0,830,12118,12948,2148,1,3,78,614,78,252,37,142,6,1
3/24/2020,712,85,711,85,1,0,683,10117,10800,1103,0,2,30,536,55,174,21,105,5,1
3/23/2020,627,122,626,122,1,0,607,9090,9697,1499,0,2,84,506,38,119,13,84,4,0
3/22/2020,505,133,504,132,1,1,490,7708,8198,1571,1,2,108,422,24,81,28,71,4,1
3/21/2020,372,151,372,151,0,0,398,6229,6627,2118,1,1,121,314,29,57,14,43,3,2
3/20/2020,221,162,221,162,0,0,252,4257,4509,1087,0,0,142,193,20,28,14,29,1,1
3/19/2020,59,30,59,30,0,0,183,3239,3422,832,0,0,22,51,8,8,9,15,0,0
3/18/2020,29,11,29,11,0,0,120,2470,2590,591,0,0,11,29,0,0,3,6,0,0
3/17/2020,18,4,18,4,0,0,86,1913,1999,1364,0,0,4,18,0,0,0,3,0,0
3/16/2020,14,4,14,4,0,0,29,606,635,162,0,0,4,14,0,0,2,3,0,0
3/15/2020,10,4,10,4,0,0,26,447,473,29,0,0,4,10,0,0,0,1,0,0
3/14/2020,6,5,6,5,0,0,25,419,444,353,0,0,5,6,0,0,1,1,0,0
3/13/2020,1,0,1,0,0,0,5,86,91,43,0,0,0,1,0,0,0,0,0,0
3/12/2020,1,1,1,1,0,0,5,43,48,46,0,0,1,1,0,0,0,0,0,0
3/11/2020,0,0,0,0,0,0,2,0,2,0,0,0,0,0,0,0,0,0,0,0
3/10/2020,0,0,0,0,0,0,2,0,2,0,0,0,0,0,0,0,0,0,0,0
3/9/2020,0,0,0,0,0,0,2,0,2,0,0,0,0,0,0,0,0,0,0,0
3/7/2020,0,0,0,0,0,0,2,0,2,0,0,0,0,0,0,0,0,0,0,0
3/6/2020,0,0,0,0,0,0,2,0,2,0,0,0,0,0,0,0,0,0,0,0
3/5/2020,0,0,0,0,0,0,2,0,2,0,0,0,0,0,0,0,0,0,0,0
